330,339,10,10,1,1,0,10,1,1,1,1,10,10,10,10,0,2,2,4,2,1,1,86,86,86,86,0,0
406,441,36,36,1,1,0,36,1,1,1,1,38,38,38,38,0,0,0,0,2,1,1,349,349,349,349,0,1
8,17,10,10,1,1,0,10,1,1,1,1,12,12,12,12,0,0,0,0,2,1,1,121,121,121,121,0,1
159,173,15,15,1,1,0,15,1,1,1,1,15,15,15,15,0,0,0,0,2,1,1,190,190,190,190,0,1
175,191,17,17,1,1,0,17,1,1,1,1,19,19,19,19,0,1,1,2,2,1,1,147,147,147,147,0,1
522,544,18,23,0.68,0.72,5,20.5,0.7165775401,0.7326203209,0.32,0.5989304813,20,25,20,25,5,0,0,0,2,1,1,137,187,137,187,50,1
95,109,15,15,1,1,0,15,1,1,1,1,17,17,17,17,0,0,0,0,2,1,1,135,135,135,135,0,1
128,158,27,31,0.3225806452,0.5806451613,4,29,0.592476489,0.736677116,0.2258064516,0.4670846395,27,31,27,31,4,0,0,0,2,1,1,319,285,285,319,34,1
89,101,10,13,0.2307692308,0.2307692308,3,11.5,0.3647058824,0.5411764706,0.2307692308,0.4,10,13,10,13,3,0,0,0,2,1,1,69,85,69,85,16,0
458,467,10,10,1,1,0,10,1,1,1,1,10,10,10,10,0,0,0,0,2,1,1,128,128,128,128,0,1
481,491,11,16,0.375,0.375,5,13.5,0.4166666667,0.5694444444,0.3125,0.4583333333,16,11,11,16,5,0,0,0,2,1,1,72,53,53,72,19,0
522,536,15,15,0.8666666667,0.9333333333,0,15,0.9401709402,0.9829059829,0.1333333333,0.7179487179,15,15,15,15,0,1,1,2,2,1,1,115,117,115,117,2,1
759,775,17,17,0.8235294118,0.8823529412,0,17,0.9029126214,0.9417475728,0.7058823529,0.8834951456,17,17,17,17,0,0,0,0,2,1,1,100,103,100,103,3,1
619,639,18,21,0.2857142857,0.8095238095,3,19.5,0.6844660194,0.8689320388,0.3333333333,0.7330097087,18,21,18,21,3,0,0,0,2,1,1,179,206,179,206,27,1
515,529,15,15,1,1,0,15,1,1,1,1,15,15,15,15,0,2,2,4,2,1,1,96,96,96,96,0,1
1238,1251,14,14,0.7142857143,1,0,14,0.9519230769,1,1,1,14,14,14,14,0,0,0,0,2,1,1,104,104,104,104,0,0
483,501,19,21,0.5454545455,0.8181818182,2,20,0.7486338798,0.8415300546,0.6363636364,0.8032786885,22,20,20,22,2,0,0,0,2,1,1,183,154,154,183,29,1
437,458,22,22,1,1,0,22,1,1,1,1,22,22,22,22,0,0,0,0,2,1,1,154,154,154,154,0,0
392,400,9,9,1,1,0,9,1,1,1,1,11,11,11,11,0,2,2,4,2,1,1,91,91,91,91,0,1
414,435,21,22,0.0454545455,0.7727272727,1,21.5,0.4205128205,0.7230769231,0.0454545455,0.4666666667,21,22,21,22,1,0,0,0,2,1,1,195,191,191,195,4,0
186,198,13,15,0.4,0.8666666667,2,14,0.8965517241,0.9770114943,0.8666666667,0.9770114943,15,13,13,15,2,2,0,2,2,1,1,87,85,85,87,2,0
87,106,20,21,0.9523809524,0.9523809524,1,20.5,0.9451219512,0.9451219512,0.5714285714,0.8231707317,21,20,20,21,1,0,0,0,2,1,1,164,155,155,164,9,1
201,222,22,22,1,1,0,22,1,1,1,1,22,22,22,22,0,0,0,0,2,1,1,149,149,149,149,0,1
51,61,11,11,0.3636363636,0.6363636364,0,11,0.5813953488,0.6976744186,0.4545454545,0.6511627907,11,11,11,11,0,0,0,0,2,1,1,39,43,39,43,4,0
433,462,30,30,1,1,0,30,1,1,1,1,30,30,30,30,0,0,0,0,2,1,1,210,210,210,210,0,1
87,105,9,19,0.1052631579,0.2105263158,10,14,0.265060241,0.4096385542,0.1578947368,0.313253012,10,19,10,19,9,0,0,0,2,1,1,76,166,76,166,90,0
325,359,35,35,1,1,0,35,1,1,1,1,35,35,35,35,0,0,0,0,2,1,1,136,136,136,136,0,1
380,402,19,23,0.1304347826,0.1739130435,4,21,0.3055555556,0.5138888889,0.1304347826,0.3333333333,19,23,19,23,4,0,0,0,2,1,1,144,216,144,216,72,0
34,48,15,15,1,1,0,15,1,1,1,1,8,8,8,8,0,0,0,0,0,0,0,50,50,50,50,0,1
414,433,20,20,1,1,0,20,1,1,1,1,21,21,21,21,0,0,0,0,2,1,1,189,189,189,189,0,1
193,198,6,6,0.8333333333,0.8333333333,0,6,0.862745098,0.862745098,0.8333333333,0.862745098,6,6,6,6,0,0,0,0,2,1,1,46,51,46,51,5,1
151,183,33,33,1,1,0,33,1,1,1,1,34,34,34,34,0,0,0,0,2,1,1,240,240,240,240,0,1
31,48,18,20,0.8,0.8,2,19,0.7972027972,0.8391608392,0.55,0.7692307692,20,18,18,20,2,0,0,0,2,1,1,133,143,133,143,10,1
183,246,64,64,0.9848484848,0.9848484848,0,64,0.990797546,0.990797546,0.2121212121,0.8021472393,66,66,66,66,0,0,0,0,2,1,1,652,646,646,652,6,1
54,62,9,9,1,1,0,9,1,1,1,1,9,9,9,9,0,0,0,0,2,1,1,62,62,62,62,0,1
18,27,10,13,0,0,3,11.5,0.4230769231,0.7692307692,0,0.5256410256,10,8,8,10,2,1,2,3,1,0,1,74,78,74,78,4,0
624,641,18,21,0.7391304348,0.7826086957,3,19.5,0.7951807229,0.813253012,0.347826087,0.656626506,23,20,20,23,3,0,0,0,2,1,1,166,137,137,166,29,1
30,44,15,15,1,1,0,15,1,1,1,1,15,15,15,15,0,0,0,0,2,1,1,72,72,72,72,0,1
134,155,22,22,0.8181818182,0.9545454545,0,22,0.9350649351,0.9675324675,0.9545454545,0.961038961,22,22,22,22,0,2,2,4,2,1,1,152,154,152,154,2,1
709,719,11,11,1,1,0,11,1,1,1,1,12,12,12,12,0,0,0,0,2,1,1,66,66,66,66,0,1
648,665,18,23,0.68,0.72,5,20.5,0.7165775401,0.7326203209,0.32,0.5989304813,25,20,20,25,5,0,0,0,2,1,1,187,137,137,187,50,1
1149,1154,6,6,0.8,1,0,6,0.9791666667,1,1,1,5,5,5,5,0,1,1,2,2,1,1,48,48,48,48,0,1
100,137,38,38,1,1,0,38,1,1,1,1,36,36,36,36,0,0,0,0,4,2,2,288,288,288,288,0,1
331,338,8,9,0.6666666667,0.8888888889,1,8.5,0.8311688312,0.8571428571,0.6666666667,0.8181818182,9,8,8,9,1,2,2,4,2,1,1,77,66,66,77,11,1
340,345,6,6,1,1,0,6,1,1,1,1,6,6,6,6,0,0,0,0,2,1,1,38,38,38,38,0,1
54,62,9,9,1,1,0,9,1,1,1,1,9,9,9,9,0,0,0,0,2,1,1,62,62,62,62,0,1
392,413,22,22,0.7727272727,0.9545454545,0,22,0.9379844961,0.984496124,0.9545454545,0.984496124,22,22,22,22,0,1,1,2,2,1,1,129,127,127,129,2,1
139,147,9,9,1,1,0,9,1,1,1,1,10,10,10,10,0,0,0,0,2,1,1,79,79,79,79,0,1
258,273,16,19,0.4210526316,0.7368421053,3,17.5,0.6649484536,0.7113402062,0.3684210526,0.6340206186,19,16,16,19,3,0,0,0,2,1,1,194,138,138,194,56,1
1337,1372,35,36,0.4736842105,0.7105263158,1,35.5,0.723183391,0.830449827,0.1578947368,0.5882352941,36,38,36,38,2,0,0,0,2,1,1,261,289,261,289,28,1
1098,1107,10,10,0.1428571429,0.4285714286,0,10,0.5555555556,0.7777777778,0.1428571429,0.5925925926,7,7,7,7,0,1,1,2,2,1,1,25,27,25,27,2,0
116,122,7,7,0.625,1,0,7,0.9240506329,1,1,1,8,8,8,8,0,0,0,0,2,1,1,79,79,79,79,0,1
458,481,24,24,1,1,0,24,1,1,1,1,24,24,24,24,0,0,0,0,2,1,1,168,168,168,168,0,1
658,677,20,20,0.9523809524,0.9523809524,0,20,0.9912280702,0.9912280702,0.9523809524,0.9912280702,21,21,21,21,0,0,0,0,2,1,1,114,114,114,114,0,1
187,203,17,17,1,1,0,17,1,1,1,1,17,17,17,17,0,0,0,0,2,1,1,182,182,182,182,0,1
184,198,15,15,1,1,0,15,1,1,1,1,15,15,15,15,0,0,0,0,2,1,1,198,198,198,198,0,1
201,207,7,7,0.1428571429,0.8571428571,0,7,0.7746478873,0.8873239437,0.8571428571,0.8732394366,7,7,7,7,0,0,0,0,2,1,1,71,64,64,71,7,1
236,241,6,6,0.6666666667,0.8333333333,0,6,0.914893617,0.9361702128,0.1666666667,0.7021276596,6,6,6,6,0,0,0,0,2,1,1,44,47,44,47,3,1
262,359,98,98,0.7959183673,1,0,98,0.9455676516,1,1,1,98,98,98,98,0,1,1,2,2,1,1,643,643,643,643,0,1
264,274,11,12,0.5,0.9166666667,1,11.5,0.8403361345,0.8823529412,0.9166666667,0.8823529412,12,11,11,12,1,0,0,0,2,1,1,119,105,105,119,14,1
683,708,26,26,0.5384615385,0.8461538462,0,26,0.8790322581,0.9677419355,0.8461538462,0.9677419355,26,26,26,26,0,0,0,0,2,1,1,124,124,124,124,0,1
142,173,32,32,1,1,0,32,1,1,1,1,33,33,33,33,0,0,0,0,2,1,1,235,235,235,235,0,1
1167,1197,31,31,0.9677419355,0.9677419355,0,31,0.9761904762,0.9880952381,0.1612903226,0.7678571429,31,31,31,31,0,1,1,2,2,1,1,168,166,166,168,2,1
204,217,14,14,1,1,0,14,1,1,1,1,15,15,15,15,0,0,0,0,2,1,1,123,123,123,123,0,1
58,70,13,13,0.8461538462,0.8461538462,0,13,0.914893617,0.9574468085,0.7692307692,0.9361702128,13,13,13,13,0,0,0,0,2,1,1,94,90,90,94,4,1
402,425,24,24,1,1,0,24,1,1,1,1,24,24,24,24,0,0,0,0,2,1,1,168,168,168,168,0,0
1041,1055,15,18,0.4444444444,0.7222222222,3,16.5,0.8108108108,0.8581081081,0.4444444444,0.7702702703,18,15,15,18,3,0,0,0,2,1,1,148,131,131,148,17,1
114,125,9,12,0.2142857143,0.5714285714,3,10.5,0.4727272727,0.6363636364,0.2857142857,0.5,11,14,11,14,3,0,0,0,2,1,1,86,110,86,110,24,0
414,433,20,20,1,1,0,20,1,1,1,1,21,21,21,21,0,0,0,0,2,1,1,189,189,189,189,0,1
341,347,7,7,0.7142857143,0.7142857143,0,7,0.8333333333,0.9333333333,0.7142857143,0.8666666667,7,7,7,7,0,0,0,0,2,1,1,30,30,30,30,0,0
572,592,21,23,0.84,0.88,2,22,0.8395721925,0.871657754,0.68,0.807486631,25,23,23,25,2,0,0,0,2,1,1,187,166,166,187,21,1
22,47,26,26,1,1,0,26,1,1,1,1,22,22,22,22,0,2,2,4,2,1,1,142,142,142,142,0,0
925,937,12,13,0.5384615385,0.8461538462,1,12.5,0.7933884298,0.9256198347,0.3076923077,0.7272727273,12,13,12,13,1,0,0,0,2,1,1,118,121,118,121,3,0
26,44,19,19,1,1,0,19,1,1,1,1,19,19,19,19,0,2,2,4,2,1,1,164,164,164,164,0,1
1158,1170,13,14,0.2857142857,0.3571428571,1,13.5,0.44,0.6,0.2857142857,0.52,14,13,13,14,1,0,0,0,2,1,1,67,75,67,75,8,1
250,259,10,10,0.7272727273,0.9090909091,0,10,0.9594594595,0.9864864865,0.8181818182,0.972972973,11,11,11,11,0,0,0,0,2,1,1,73,74,73,74,1,1
945,954,10,10,1,1,0,10,1,1,1,1,9,9,9,9,0,1,1,2,2,1,1,84,84,84,84,0,1
115,125,11,11,0.6666666667,0.6666666667,0,11,0.8636363636,0.9090909091,0.4166666667,0.7272727273,12,12,12,12,0,0,0,0,2,1,1,88,82,82,88,6,1
91,106,11,16,0,0,5,13.5,0.3076923077,0.5769230769,0,0.5,6,6,6,6,0,0,0,0,0,0,0,26,24,24,26,2,0
120,136,17,17,0.5263157895,0.9473684211,0,17,0.8736263736,0.956043956,0.9473684211,0.9505494505,19,19,19,19,0,0,1,1,2,1,1,176,182,176,182,6,1
792,826,35,35,1,1,0,35,1,1,1,1,36,36,36,36,0,0,0,0,2,1,1,217,217,217,217,0,1
126,130,5,5,1,1,0,5,1,1,1,1,5,5,5,5,0,0,0,0,2,1,1,60,60,60,60,0,1
32,51,18,20,0.8,0.8,2,19,0.8796992481,0.9323308271,0.55,0.8571428571,18,20,18,20,2,0,0,0,2,1,1,126,133,126,133,7,1
1085,1096,12,14,0.6153846154,0.8461538462,2,13,0.8275862069,0.8620689655,0.2307692308,0.724137931,13,11,11,13,2,1,1,2,2,1,1,116,100,100,116,16,0
1182,1203,18,22,0.6363636364,0.7272727273,4,20,0.7564102564,0.8076923077,0.2727272727,0.6730769231,18,22,18,22,4,0,0,0,2,1,1,130,156,130,156,26,1
38,63,26,40,0.1463414634,0.1707317073,14,33,0.2739273927,0.4554455446,0.1463414634,0.3234323432,41,26,26,41,15,0,0,0,2,1,1,303,193,193,303,110,0
153,163,11,12,0.1818181818,0.4545454545,1,11.5,0.3703703704,0.4691358025,0.1818181818,0.3827160494,11,11,11,11,0,0,1,1,3,2,1,81,56,56,81,25,0
159,166,8,10,0.4,0.7,2,9,0.641025641,0.7435897436,0.3,0.6153846154,10,8,8,10,2,0,0,0,2,1,1,39,31,31,39,8,0
873,899,27,27,0.9259259259,1,0,27,0.9896373057,1,1,1,27,27,27,27,0,0,0,0,2,1,1,193,193,193,193,0,1
341,371,31,31,1,1,0,31,1,1,1,1,31,31,31,31,0,0,0,0,2,1,1,217,217,217,217,0,0
321,359,34,39,0.1428571429,0.1428571429,5,36.5,0.3653333333,0.608,0.119047619,0.4186666667,36,42,36,42,6,0,0,0,2,1,1,362,375,362,375,13,0
723,739,17,18,0.7777777778,0.8333333333,1,17.5,0.8837209302,0.9224806202,0.3333333333,0.7209302326,18,17,17,18,1,0,0,0,2,1,1,129,121,121,129,8,1
181,187,7,7,0.375,0.75,0,7,0.6901408451,0.8028169014,0.625,0.7887323944,8,8,8,8,0,0,0,0,2,1,1,57,71,57,71,14,0
364,428,65,65,1,1,0,65,1,1,1,1,65,65,65,65,0,1,1,2,2,1,1,415,415,415,415,0,1
590,601,12,12,0.9166666667,1,0,12,0.9915966387,1,1,1,12,12,12,12,0,0,0,0,2,1,1,119,119,119,119,0,1
219,230,12,12,1,1,0,12,1,1,1,1,13,13,13,13,0,0,0,0,2,1,1,80,80,80,80,0,1
101,111,11,14,0.2142857143,0.3571428571,3,12.5,0.3510638298,0.5212765957,0.2142857143,0.3936170213,14,11,11,14,3,0,0,0,2,1,1,94,60,60,94,34,0
70,110,24,41,0,0.4444444444,17,32.5,0.6388888889,0.8611111111,0.4444444444,0.7638888889,9,9,9,9,0,0,0,0,0,0,0,70,72,70,72,2,0
117,151,35,35,1,1,0,35,1,1,1,1,37,37,37,37,0,1,1,2,4,2,2,285,285,285,285,0,1
66,75,10,15,0.2666666667,0.2666666667,5,12.5,0.3428571429,0.4714285714,0.2666666667,0.3714285714,15,10,10,15,5,0,0,0,3,2,1,70,55,55,70,15,0
79,86,8,9,0.3333333333,0.6666666667,1,8.5,0.4423076923,0.5769230769,0.3333333333,0.4807692308,9,8,8,9,1,0,0,0,2,1,1,40,52,40,52,12,0
122,127,6,6,0.7142857143,1,0,6,0.9275362319,1,1,1,7,7,7,7,0,1,1,2,2,1,1,69,69,69,69,0,0
333,374,41,42,0.9761904762,0.9761904762,1,41.5,0.9678571429,0.9678571429,0.619047619,0.8821428571,41,42,41,42,1,0,0,0,2,1,1,271,280,271,280,9,1
20,32,13,13,0.9285714286,0.9285714286,0,13,0.8648648649,0.8738738739,0.9285714286,0.8738738739,14,14,14,14,0,1,1,2,2,1,1,97,111,97,111,14,1
84,102,19,19,0.6818181818,0.9090909091,0,19,0.9253731343,0.960199005,0.1818181818,0.671641791,22,22,22,22,0,1,1,2,2,1,1,201,199,199,201,2,1
194,203,10,10,1,1,0,10,1,1,1,1,8,8,8,8,0,0,0,0,2,1,1,59,59,59,59,0,1
362,393,32,32,1,1,0,32,1,1,1,1,32,32,32,32,0,0,0,0,2,1,1,398,398,398,398,0,1
737,767,31,31,1,1,0,31,1,1,1,1,22,22,22,22,0,0,0,0,4,2,2,171,171,171,171,0,0
799,808,10,10,0.5833333333,0.8333333333,0,10,0.8023255814,0.9069767442,0.3333333333,0.6860465116,12,12,12,12,0,0,0,0,2,1,1,86,86,86,86,0,1
96,102,7,7,0.5714285714,0.7142857143,0,7,0.6,0.7428571429,0.5714285714,0.6285714286,7,7,7,7,0,0,0,0,4,2,2,35,26,26,35,9,0
264,282,18,19,0.5789473684,0.9473684211,1,18.5,0.9322916667,0.9635416667,0.7368421053,0.9322916667,18,19,18,19,1,0,0,0,2,1,1,185,192,185,192,7,1
74,78,5,5,1,1,0,5,1,1,1,1,6,6,6,6,0,0,0,0,2,1,1,51,51,51,51,0,1
357,382,26,26,1,1,0,26,1,1,1,1,26,26,26,26,0,0,0,0,2,1,1,182,182,182,182,0,0
1012,1031,13,20,0.1428571429,0.2380952381,7,16.5,0.4038461538,0.5833333333,0.0952380952,0.4038461538,14,21,14,21,7,0,0,0,3,2,1,156,144,144,156,12,0
784,790,7,7,1,1,0,7,1,1,1,1,7,7,7,7,0,0,0,0,2,1,1,101,101,101,101,0,0
322,343,22,22,1,1,0,22,1,1,1,1,22,22,22,22,0,0,0,0,2,1,1,154,154,154,154,0,0
97,103,7,7,0.875,1,0,7,0.9852941176,1,1,1,8,8,8,8,0,1,1,2,2,1,1,68,68,68,68,0,1
113,120,8,8,0.375,0.75,0,8,0.4210526316,0.5438596491,0.5,0.4385964912,8,8,8,8,0,0,0,0,2,1,1,57,41,41,57,16,0
432,455,24,24,1,1,0,24,1,1,1,1,24,24,24,24,0,0,0,0,2,1,1,168,168,168,168,0,1
222,272,51,51,1,1,0,51,1,1,1,1,48,48,48,48,0,1,1,2,4,2,2,322,322,322,322,0,1
474,483,10,10,1,1,0,10,1,1,1,1,11,11,11,11,0,0,0,0,2,1,1,78,78,78,78,0,1
405,419,15,15,0.6666666667,0.6666666667,0,15,0.9428571429,0.9428571429,0.6666666667,0.9428571429,15,15,15,15,0,0,0,0,2,1,1,99,105,99,105,6,1
163,172,10,10,0.9,1,0,10,0.9677419355,1,1,1,10,10,10,10,0,0,0,0,2,1,1,62,62,62,62,0,1
54,65,12,12,1,1,0,12,1,1,1,1,12,12,12,12,0,0,0,0,2,1,1,79,79,79,79,0,1
970,989,20,21,0.7619047619,0.8571428571,1,20.5,0.7967914439,0.871657754,0.2857142857,0.7272727273,21,20,20,21,1,0,0,0,2,1,1,187,170,170,187,17,1
128,144,17,17,0.7368421053,1,0,17,0.9537572254,1,1,1,19,19,19,19,0,1,1,2,2,1,1,173,173,173,173,0,1
753,759,7,7,0.5714285714,1,0,7,0.9436619718,1,1,1,7,7,7,7,0,1,1,2,2,1,1,71,71,71,71,0,1
113,124,12,12,1,1,0,12,1,1,1,1,12,12,12,12,0,0,0,0,2,1,1,67,67,67,67,0,1
82,92,11,11,0.6363636364,1,0,11,0.8641975309,1,1,1,11,11,11,11,0,0,0,0,2,1,1,81,81,81,81,0,0
204,208,5,5,0.2,0.8,0,5,0.7157894737,0.9473684211,0.8,0.8947368421,5,5,5,5,0,0,0,0,2,1,1,93,95,93,95,2,1
87,103,17,17,1,1,0,17,1,1,1,1,17,17,17,17,0,0,0,0,2,1,1,144,144,144,144,0,1
88,106,19,19,0.5789473684,0.8947368421,0,19,0.8159509202,0.8588957055,0.3157894737,0.6748466258,19,19,19,19,0,0,0,0,2,1,1,163,148,148,163,15,1
619,627,9,9,1,1,0,9,1,1,1,1,10,10,10,10,0,0,0,0,2,1,1,78,78,78,78,0,1
382,392,11,12,0.5833333333,0.9166666667,1,11.5,0.9017857143,0.9375,0.3333333333,0.7767857143,12,11,11,12,1,0,0,0,2,1,1,112,105,105,112,7,1
16,26,11,11,0.9230769231,0.9230769231,0,11,0.9924242424,0.9924242424,0.9230769231,0.9924242424,13,13,13,13,0,1,1,2,2,1,1,132,132,132,132,0,1
409,437,29,29,1,1,0,29,1,1,1,1,29,29,29,29,0,2,2,4,2,1,1,266,266,266,266,0,1
468,485,18,18,0.3333333333,0.9444444444,0,18,0.7621621622,0.9675675676,0.3888888889,0.8162162162,18,18,18,18,0,0,0,0,2,1,1,185,179,179,185,6,1
647,672,26,26,0.8518518519,0.962962963,0,26,0.9651741294,0.9850746269,0.7407407407,0.9004975124,27,27,27,27,0,1,1,2,4,2,2,201,198,198,201,3,1
132,152,21,21,0.9545454545,0.9545454545,0,21,0.9818181818,0.9818181818,0.9545454545,0.9818181818,22,22,22,22,0,0,0,0,2,1,1,165,162,162,165,3,1
151,161,11,11,0,0,0,11,0.25,0.5416666667,0,0.4166666667,6,6,6,6,0,0,0,0,0,0,0,18,24,18,24,6,0
493,504,12,14,0.5,0.8571428571,2,13,0.7862068966,0.8206896552,0.5714285714,0.8,14,12,12,14,2,0,0,0,2,1,1,145,119,119,145,26,1
528,543,16,18,0.3888888889,0.7222222222,2,17,0.7336956522,0.8369565217,0.2777777778,0.6739130435,18,16,16,18,2,0,0,0,2,1,1,184,157,157,184,27,1
646,655,10,11,0.5384615385,0.7692307692,1,10.5,0.8131868132,0.9010989011,0.2307692308,0.6703296703,13,12,12,13,1,0,0,0,2,1,1,91,86,86,91,5,0
1454,1459,6,6,0.8,1,0,6,0.9791666667,1,1,1,5,5,5,5,0,1,1,2,2,1,1,48,48,48,48,0,1
446,458,13,15,0.8125,0.8125,2,14,0.9761904762,0.9761904762,0.8125,0.9761904762,16,14,14,16,2,0,0,0,2,1,1,84,82,82,84,2,1
579,587,9,9,0.4444444444,1,0,9,0.8775510204,1,1,1,9,9,9,9,0,0,0,0,2,1,1,49,49,49,49,0,1
67,78,12,14,0.7142857143,0.8571428571,2,13,0.8068181818,0.8295454545,0.4285714286,0.6704545455,14,12,12,14,2,0,0,0,2,1,1,88,73,73,88,15,1
145,151,7,7,0.625,0.875,0,7,0.8421052632,0.8947368421,0.375,0.6578947368,8,8,8,8,0,1,1,2,2,1,1,68,76,68,76,8,1
81,89,9,9,0.8888888889,0.8888888889,0,9,0.9880952381,0.9880952381,0.8888888889,0.9880952381,9,9,9,9,0,0,0,0,2,1,1,84,83,83,84,1,1
1,49,41,49,0.9761904762,0.9761904762,8,45,0.9884057971,0.9884057971,0.9761904762,0.9884057971,41,42,41,42,1,0,1,1,0,0,0,341,345,341,345,4,0
379,454,76,77,0.8939393939,0.9848484848,1,76.5,0.9477434679,0.9976247031,0.6818181818,0.9501187648,66,65,65,66,1,1,0,1,2,1,1,421,420,420,421,1,1
591,598,8,8,1,1,0,8,1,1,1,1,8,8,8,8,0,0,0,0,2,1,1,93,93,93,93,0,1
32,51,20,21,0.619047619,0.8095238095,1,20.5,0.7567567568,0.8378378378,0.380952381,0.722972973,21,20,20,21,1,0,0,0,2,1,1,148,133,133,148,15,1
138,152,15,15,0.5882352941,0.8823529412,0,15,0.8484848485,0.903030303,0.2352941176,0.6484848485,17,17,17,17,0,0,0,0,2,1,1,149,165,149,165,16,1
209,218,7,10,0.1,0.2,3,8.5,0.4181818182,0.6363636364,0.1,0.4727272727,7,10,7,10,3,1,0,1,2,1,1,50,55,50,55,5,0
413,448,36,36,1,1,0,36,1,1,1,1,38,38,38,38,0,0,0,0,2,1,1,349,349,349,349,0,1
888,914,27,34,0.5294117647,0.7352941176,7,30.5,0.7380952381,0.8,0.3235294118,0.6428571429,34,27,27,34,7,0,0,0,2,1,1,210,175,175,210,35,1
1,63,63,63,1,1,0,63,1,1,1,1,57,57,57,57,0,0,0,0,0,0,0,545,545,545,545,0,1
343,348,6,6,0.8571428571,0.8571428571,0,6,0.976744186,0.976744186,0.8571428571,0.976744186,7,7,7,7,0,2,2,4,2,1,1,84,86,84,86,2,1
146,168,23,23,0.9130434783,0.9565217391,0,23,0.9307692308,0.9615384615,0.9565217391,0.9461538462,23,23,23,23,0,0,0,0,2,1,1,130,126,126,130,4,1
183,193,11,18,0.2,0.2,7,14.5,0.3333333333,0.5098039216,0.2,0.431372549,9,10,9,10,1,0,0,0,4,2,2,51,50,50,51,1,0
299,318,20,20,1,1,0,20,1,1,1,1,20,20,20,20,0,0,0,0,2,1,1,227,227,227,227,0,1
257,350,94,94,0.9848484848,0.9848484848,0,94,0.977086743,0.977086743,0.1060606061,0.682487725,66,66,66,66,0,1,1,2,2,1,1,597,611,597,611,14,1
667,685,18,19,0.8571428571,0.9047619048,1,18.5,0.8724832215,0.8926174497,0.7142857143,0.8187919463,20,21,20,21,1,0,0,0,2,1,1,137,149,137,149,12,1
383,482,100,100,1,1,0,100,1,1,1,1,111,111,111,111,0,0,0,0,2,1,1,1014,1014,1014,1014,0,1
13,34,18,22,0.8181818182,0.8181818182,4,20,0.8014184397,0.8014184397,0.7727272727,0.7943262411,18,22,18,22,4,0,0,0,2,1,1,113,141,113,141,28,1
509,520,12,12,1,1,0,12,1,1,1,1,13,13,13,13,0,0,0,0,2,1,1,123,123,123,123,0,1
88,104,17,17,0.6315789474,1,0,17,0.9421965318,1,1,1,19,19,19,19,0,1,1,2,2,1,1,173,173,173,173,0,1
700,712,13,13,0.8461538462,1,0,13,0.9385964912,1,1,1,13,13,13,13,0,0,0,0,2,1,1,114,114,114,114,0,1
831,840,10,10,0.5555555556,0.8888888889,0,10,0.8,0.9333333333,0.8888888889,0.9333333333,9,9,9,9,0,1,1,2,2,1,1,60,56,56,60,4,0
164,174,11,11,1,1,0,11,1,1,1,1,13,13,13,13,0,2,2,4,2,1,1,119,119,119,119,0,1
433,473,41,41,1,1,0,41,1,1,1,1,41,41,41,41,0,0,0,0,2,1,1,287,287,287,287,0,1
338,349,12,14,0.2857142857,0.3571428571,2,13,0.3723404255,0.5531914894,0.2857142857,0.4468085106,14,12,12,14,2,0,0,0,2,1,1,94,68,68,94,26,0
11,18,8,8,0.25,0.875,0,8,0.8448275862,0.9655172414,0.125,0.7931034483,8,8,8,8,0,0,0,0,0,0,0,56,58,56,58,2,0
1182,1201,18,20,0.3,0.9,2,19,0.824120603,0.9296482412,0.7,0.8994974874,18,20,18,20,2,0,0,0,2,1,1,185,199,185,199,14,1
53,166,114,114,0.9915966387,0.9915966387,0,114,0.9990749306,0.9990749306,0.9915966387,0.9990749306,119,119,119,119,0,0,0,0,2,1,1,1081,1081,1081,1081,0,1
77,88,12,12,0.9230769231,1,0,12,0.9902912621,1,1,1,13,13,13,13,0,1,1,2,2,1,1,103,103,103,103,0,1
58,60,3,3,0.3333333333,0.6666666667,0,3,0.9577464789,0.985915493,0,0.9295774648,3,3,3,3,0,0,0,0,2,1,1,71,70,70,71,1,1
836,852,17,18,0.3333333333,0.9444444444,1,17.5,0.827027027,0.9621621622,0.7222222222,0.9297297297,18,17,17,18,1,0,0,0,2,1,1,185,178,178,185,7,1
159,173,15,15,1,1,0,15,1,1,1,1,15,15,15,15,0,0,0,0,2,1,1,190,190,190,190,0,1
429,437,9,9,0.4444444444,0.7777777778,0,9,0.6181818182,0.7272727273,0.4444444444,0.6363636364,9,9,9,9,0,0,0,0,2,1,1,55,41,41,55,14,1
629,646,18,21,0.7391304348,0.7826086957,3,19.5,0.7951807229,0.813253012,0.347826087,0.656626506,23,20,20,23,3,0,0,0,2,1,1,166,137,137,166,29,1
243,258,16,17,0.3529411765,0.9411764706,1,16.5,0.8370786517,0.9606741573,0.7058823529,0.9269662921,17,16,16,17,1,0,0,0,2,1,1,178,171,171,178,7,1
363,375,11,13,0.5384615385,0.6153846154,2,12,0.7722772277,0.801980198,0.2307692308,0.6237623762,11,13,11,13,2,0,0,0,2,1,1,84,101,84,101,17,1
355,396,42,42,1,1,0,42,1,1,1,1,42,42,42,42,0,0,0,0,2,1,1,255,255,255,255,0,1
106,122,17,17,0.7368421053,1,0,17,0.9695121951,1,1,1,19,19,19,19,0,1,1,2,2,1,1,164,164,164,164,0,1
63,79,17,17,0.6470588235,0.7058823529,0,17,0.696,0.76,0.4117647059,0.64,17,17,17,17,0,0,0,0,2,1,1,108,125,108,125,17,1
476,485,10,10,1,1,0,10,1,1,1,1,11,11,11,11,0,0,0,0,2,1,1,78,78,78,78,0,1
25,32,7,8,0.7777777778,0.8888888889,1,7.5,0.8857142857,0.9,0.8888888889,0.9,8,9,8,9,1,0,0,0,2,1,1,63,70,63,70,7,1
855,865,11,12,0.9166666667,0.9166666667,1,11.5,0.9108910891,0.9108910891,0.9166666667,0.9108910891,12,11,11,12,1,0,0,0,2,1,1,101,92,92,101,9,1
358,370,13,13,1,1,0,13,1,1,1,1,13,13,13,13,0,2,2,4,2,1,1,103,103,103,103,0,1
174,207,34,34,0.6944444444,0.8611111111,0,34,0.9493670886,0.9683544304,0.8611111111,0.9683544304,36,36,36,36,0,0,0,0,2,1,1,316,307,307,316,9,1
77,84,8,8,0.625,0.875,0,8,0.9482758621,0.9827586207,0.875,0.9827586207,8,8,8,8,0,0,0,0,2,1,1,58,58,58,58,0,1
326,347,22,22,1,1,0,22,1,1,1,1,22,22,22,22,0,0,0,0,2,1,1,154,154,154,154,0,1
11,24,14,14,0.9090909091,1,0,14,0.9814814815,1,1,1,11,11,11,11,0,0,0,0,0,0,0,54,54,54,54,0,1
192,198,7,7,0.1428571429,0.7142857143,0,7,0.35,0.625,0.1428571429,0.375,7,7,7,7,0,0,0,0,2,1,1,40,26,26,40,14,0
140,166,19,27,0.5555555556,0.7037037037,8,23,0.58,0.61,0.2222222222,0.465,19,27,19,27,8,0,0,0,2,1,1,122,200,122,200,78,1
570,590,19,21,0.7391304348,0.7826086957,2,20,0.8192771084,0.8614457831,0.347826087,0.6987951807,21,23,21,23,2,0,0,0,2,1,1,149,166,149,166,17,1
92,105,11,14,0.1428571429,0.2142857143,3,12.5,0.3737373737,0.6161616162,0.1428571429,0.4646464646,11,14,11,14,3,0,0,0,2,1,1,99,88,88,99,11,0
373,384,12,12,0.3333333333,0.4166666667,0,12,0.4347826087,0.6086956522,0.3333333333,0.4492753623,12,12,12,12,0,0,0,0,2,1,1,65,69,65,69,4,0
96,107,12,12,1,1,0,12,1,1,1,1,12,12,12,12,0,0,0,0,2,1,1,67,67,67,67,0,1
1295,1330,35,36,0.4736842105,0.7105263158,1,35.5,0.723183391,0.830449827,0.1578947368,0.5882352941,36,38,36,38,2,0,0,0,2,1,1,261,289,261,289,28,1
353,363,11,11,1,1,0,11,1,1,1,1,11,11,11,11,0,0,0,0,2,1,1,96,96,96,96,0,1
47,61,15,15,1,1,0,15,1,1,1,1,15,15,15,15,0,0,0,0,2,1,1,114,114,114,114,0,1
457,486,30,30,1,1,0,30,1,1,1,1,30,30,30,30,0,0,0,0,2,1,1,210,210,210,210,0,0
365,388,24,24,1,1,0,24,1,1,1,1,24,24,24,24,0,0,0,0,2,1,1,168,168,168,168,0,1
546,568,23,23,1,1,0,23,1,1,1,1,25,25,25,25,0,0,0,0,2,1,1,187,187,187,187,0,1
328,347,20,20,1,1,0,20,1,1,1,1,23,23,23,23,0,0,0,0,2,1,1,269,269,269,269,0,1
144,151,8,9,0,0,1,8.5,0.2530120482,0.421686747,0,0.3253012048,10,9,9,10,1,2,1,3,2,1,1,66,83,66,83,17,0
282,294,13,13,1,1,0,13,1,1,1,1,15,15,15,15,0,0,0,0,2,1,1,135,135,135,135,0,1
128,133,6,6,1,1,0,6,1,1,1,1,6,6,6,6,0,1,1,2,2,1,1,49,49,49,49,0,1
85,101,17,17,0.8421052632,0.8421052632,0,17,0.8928571429,0.8928571429,0.8421052632,0.8928571429,19,17,17,19,2,1,2,3,2,1,1,168,151,151,168,17,1
526,534,9,9,1,1,0,9,1,1,1,1,10,10,10,10,0,0,0,0,2,1,1,109,109,109,109,0,1
480,500,21,21,0.7083333333,1,0,21,0.9466019417,1,1,1,24,24,24,24,0,1,1,2,2,1,1,206,206,206,206,0,0
39,56,18,23,0.1304347826,0.1739130435,5,20.5,0.3296703297,0.489010989,0.1304347826,0.3516483516,23,18,18,23,5,0,0,0,2,1,1,182,117,117,182,65,0
404,437,30,34,0.6764705882,0.7352941176,4,32,0.7412587413,0.7762237762,0.4117647059,0.6643356643,30,34,30,34,4,0,0,0,2,1,1,234,286,234,286,52,1
79,88,10,10,0.9,1,0,10,0.9891304348,1,1,1,10,10,10,10,0,0,0,0,2,1,1,92,92,92,92,0,1
23,246,224,283,1,1,59,253.5,1,1,1,1,197,197,197,197,0,0,0,0,0,0,0,1363,1363,1363,1363,0,1
127,136,10,10,0.2,0.3,0,10,0.3428571429,0.6142857143,0.2,0.4571428571,10,10,10,10,0,0,0,0,2,1,1,70,59,59,70,11,0
393,410,18,18,0.8888888889,1,0,18,0.9763779528,1,1,1,18,18,18,18,0,0,0,0,2,1,1,127,127,127,127,0,1
714,721,8,8,0.875,0.875,0,8,0.9344262295,0.9344262295,0.25,0.6721311475,8,8,8,8,0,1,1,2,2,1,1,61,59,59,61,2,1
556,579,24,24,1,1,0,24,1,1,1,1,24,24,24,24,0,0,0,0,2,1,1,168,168,168,168,0,0
110,260,151,151,1,1,0,151,1,1,1,1,142,142,142,142,0,1,1,2,4,2,2,1042,1042,1042,1042,0,0
85,94,10,10,0.9,1,0,10,0.9836065574,1,1,1,10,10,10,10,0,0,0,0,2,1,1,61,61,61,61,0,1
640,653,12,14,0.4285714286,0.7857142857,2,13,0.693877551,0.7619047619,0.2857142857,0.6326530612,12,14,12,14,2,0,0,0,2,1,1,112,147,112,147,35,1
276,288,13,14,0.5714285714,0.9285714286,1,13.5,0.8455284553,0.9268292683,0.4285714286,0.7723577236,14,13,13,14,1,0,0,0,2,1,1,123,114,114,123,9,0
87,96,10,10,0.2,0.3,0,10,0.3684210526,0.5789473684,0.2,0.4210526316,10,10,10,10,0,0,0,0,3,1,2,76,64,64,76,12,0
306,344,39,39,0.8974358974,0.8974358974,0,39,0.9506578947,0.9506578947,0.4615384615,0.7105263158,39,39,39,39,0,0,0,0,2,1,1,304,297,297,304,7,1
124,132,9,9,0.5,1,0,9,0.968,1,1,1,8,8,8,8,0,1,1,2,4,2,2,125,125,125,125,0,1
394,404,11,11,1,1,0,11,1,1,1,1,12,12,12,12,0,0,0,0,2,1,1,159,159,159,159,0,1
19,34,16,16,1,1,0,16,1,1,1,1,16,16,16,16,0,0,0,0,2,1,1,119,119,119,119,0,1
425,441,17,17,0.5263157895,0.8421052632,0,17,0.8352272727,0.8977272727,0.4210526316,0.6875,19,19,19,19,0,0,1,1,2,1,1,176,166,166,176,10,1
1132,1144,13,14,0.2727272727,0.3636363636,1,13.5,0.4905660377,0.7169811321,0.2727272727,0.5660377358,11,10,10,11,1,1,0,1,4,2,2,53,53,53,53,0,0
778,795,18,18,0.7777777778,0.9444444444,0,18,0.9302325581,0.976744186,0.3333333333,0.7596899225,18,18,18,18,0,0,0,0,2,1,1,127,129,127,129,2,1
64,71,8,8,1,1,0,8,1,1,1,1,9,9,9,9,0,0,0,0,2,1,1,62,62,62,62,0,1
385,390,6,6,1,1,0,6,1,1,1,1,7,7,7,7,0,0,0,0,2,1,1,64,64,64,64,0,1
648,665,18,21,0.7391304348,0.7826086957,3,19.5,0.7951807229,0.813253012,0.347826087,0.656626506,23,20,20,23,3,0,0,0,2,1,1,166,137,137,166,29,1
39,49,11,11,1,1,0,11,1,1,1,1,12,12,12,12,0,0,0,0,2,1,1,77,77,77,77,0,1
113,124,12,12,1,1,0,12,1,1,1,1,12,12,12,12,0,0,0,0,2,1,1,67,67,67,67,0,1
450,467,18,18,1,1,0,18,1,1,1,1,18,18,18,18,0,0,0,0,2,1,1,201,201,201,201,0,1
349,354,6,7,0.1428571429,0.7142857143,1,6.5,0.46,0.74,0.1428571429,0.56,7,6,6,7,1,0,0,0,2,1,1,50,42,42,50,8,0
106,112,7,7,0.625,0.875,0,7,0.8481012658,0.8987341772,0.25,0.6455696203,8,8,8,8,0,0,0,0,2,1,1,71,79,71,79,8,1
108,113,6,6,0.6666666667,0.8333333333,0,6,0.8888888889,0.962962963,0.8333333333,0.962962963,6,6,6,6,0,0,0,0,2,1,1,27,26,26,27,1,0
807,809,3,3,0.6666666667,1,0,3,0.95,1,1,1,6,6,6,6,0,0,0,0,2,1,1,40,40,40,40,0,0
570,590,21,23,0.84,0.88,2,22,0.8395721925,0.871657754,0.68,0.807486631,25,23,23,25,2,0,0,0,2,1,1,187,166,166,187,21,1
776,787,12,12,0.6666666667,0.9166666667,0,12,0.8596491228,0.9298245614,0.4166666667,0.7807017544,12,12,12,12,0,0,0,0,2,1,1,114,108,108,114,6,1
570,590,18,21,0.7391304348,0.7826086957,3,19.5,0.7951807229,0.813253012,0.347826087,0.656626506,20,23,20,23,3,0,0,0,2,1,1,137,166,137,166,29,0
4,22,13,19,0,0.2727272727,6,16,0.2878787879,0.5151515152,0,0.3484848485,8,11,8,11,3,1,2,3,2,1,1,56,66,56,66,10,0
483,753,271,271,0.3982300885,0.9955752212,0,271,0.7391304348,0.9974424552,0.9955752212,0.9974424552,226,226,226,226,0,1,0,1,2,1,1,1171,1173,1171,1173,2,1
18,275,258,258,1,1,0,258,1,1,1,1,225,225,225,225,0,0,0,0,0,0,0,1865,1865,1865,1865,0,1
407,421,13,15,0,0,2,14,0.3893129771,0.6106870229,0,0.4198473282,13,14,13,14,1,1,5,6,3,1,2,123,131,123,131,8,0
19,34,16,16,1,1,0,16,1,1,1,1,16,16,16,16,0,0,0,0,2,1,1,119,119,119,119,0,1
18,31,14,14,0.9333333333,0.9333333333,0,14,0.992,0.992,0.7333333333,0.96,15,15,15,15,0,0,0,0,2,1,1,124,125,124,125,1,1
42,62,21,21,0.9523809524,1,0,21,0.9933333333,1,1,1,21,21,21,21,0,2,2,4,2,1,1,150,150,150,150,0,1
804,903,92,100,0.9375,0.9583333333,8,96,0.9295774648,0.9323943662,0.6979166667,0.876056338,92,96,92,96,4,1,1,2,2,1,1,662,710,662,710,48,1
208,245,38,38,0.7857142857,1,0,38,0.9616724739,1,1,1,42,42,42,42,0,4,4,8,2,1,1,287,287,287,287,0,1
10,10,1,289,0.0357142857,0.0357142857,288,145,0.9316466933,0.9316466933,0.0357142857,0.9316466933,28,1,1,28,27,1,0,1,0,0,0,2253,2099,2099,2253,154,0
10,1468,1,1459,0.0384615385,0.0384615385,1458,730,0.9333036905,0.9333036905,0.0384615385,0.9333036905,1,26,1,26,25,0,1,1,0,0,0,2099,2249,2099,2249,150,0
1340,1355,16,18,0.7142857143,0.7142857143,2,17,0.7659574468,0.7659574468,0.2380952381,0.5957446809,21,18,18,21,3,0,0,0,2,1,1,141,118,118,141,23,1
215,234,20,20,0.2380952381,0.2380952381,0,20,0.4096385542,0.6265060241,0.2380952381,0.4457831325,21,21,21,21,0,0,0,0,3,1,2,144,166,144,166,22,0
342,398,57,57,1,1,0,57,1,1,1,1,53,53,53,53,0,1,1,2,4,2,2,346,346,346,346,0,0
202,211,10,41,0.0714285714,0.0714285714,31,25.5,0.1955835962,0.3154574132,0.0476190476,0.1955835962,42,11,11,42,31,0,0,0,2,1,1,317,124,124,317,193,0
18,21,4,4,0.5,0.5,0,4,0.7613636364,0.7727272727,0.5,0.7727272727,4,4,4,4,0,2,1,3,2,1,1,69,88,69,88,19,0
910,922,12,13,0.5384615385,0.8461538462,1,12.5,0.7933884298,0.9256198347,0.3076923077,0.7272727273,12,13,12,13,1,0,0,0,2,1,1,118,121,118,121,3,0
116,125,10,10,0.4,0.9,0,10,0.7808219178,0.904109589,0.9,0.904109589,10,10,10,10,0,0,0,0,2,1,1,73,67,67,73,6,1
197,202,6,23,0.0909090909,0.1818181818,17,14.5,0.3229166667,0.53125,0.0909090909,0.3645833333,11,8,8,11,3,1,2,3,3,2,1,96,74,74,96,22,0
1340,1343,4,4,0,0.75,0,4,0.5816326531,0.6632653061,0.75,0.6632653061,4,4,4,4,0,0,0,0,2,1,1,68,98,68,98,30,1
542,552,11,11,0.8333333333,0.9166666667,0,11,0.9428571429,0.9857142857,0.1666666667,0.7714285714,12,12,12,12,0,3,3,6,2,1,1,70,70,70,70,0,1
477,490,14,14,1,1,0,14,1,1,1,1,14,14,14,14,0,1,1,2,2,1,1,114,114,114,114,0,1
626,651,26,26,0.8518518519,0.962962963,0,26,0.9651741294,0.9850746269,0.7407407407,0.9004975124,27,27,27,27,0,1,1,2,4,2,2,198,201,198,201,3,1
261,293,33,33,1,1,0,33,1,1,1,1,35,35,35,35,0,0,0,0,2,1,1,342,342,342,342,0,1
227,241,15,15,0.7647058824,1,0,15,0.9727891156,1,1,1,17,17,17,17,0,0,0,0,2,1,1,147,147,147,147,0,0
202,265,64,64,1,1,0,64,1,1,1,1,64,64,64,64,0,0,0,0,2,1,1,511,511,511,511,0,1
465,478,14,14,0.8571428571,1,0,14,0.9213483146,1,1,1,14,14,14,14,0,0,0,0,2,1,1,89,89,89,89,0,1
377,398,22,22,1,1,0,22,1,1,1,1,22,22,22,22,0,0,0,0,2,1,1,154,154,154,154,0,0
544,574,31,31,0.84375,0.96875,0,31,0.9520295203,0.9889298893,0.96875,0.9741697417,32,32,32,32,0,2,2,4,4,2,2,269,271,269,271,2,1
33,56,15,24,0.125,0.2916666667,9,19.5,0.4295774648,0.6830985915,0.2083333333,0.5211267606,15,24,15,24,9,0,0,0,2,1,1,117,142,117,142,25,0
345,355,11,11,0.5454545455,1,0,11,0.8421052632,1,1,1,11,11,11,11,0,0,0,0,2,1,1,57,57,57,57,0,1
755,773,19,22,0.3636363636,0.7272727273,3,20.5,0.6034482759,0.7931034483,0.5,0.6724137931,22,19,19,22,3,0,0,0,2,1,1,116,96,96,116,20,0
37,55,19,19,0.9444444444,0.9444444444,0,19,0.9555555556,0.962962963,0.2777777778,0.6888888889,18,18,18,18,0,1,1,2,4,2,2,135,131,131,135,4,1
744,754,10,11,0.7692307692,0.7692307692,1,10.5,0.8282828283,0.8787878788,0.3846153846,0.6565656566,12,13,12,13,1,0,0,0,2,1,1,91,99,91,99,8,1
522,546,25,25,0.8461538462,1,0,25,0.9759615385,1,1,1,26,26,26,26,0,1,1,2,4,2,2,208,208,208,208,0,1
544,574,31,31,0.84375,0.96875,0,31,0.9520295203,0.9889298893,0.96875,0.9741697417,32,32,32,32,0,2,2,4,4,2,2,269,271,269,271,2,1
381,392,12,12,1,1,0,12,1,1,1,1,14,14,14,14,0,0,0,0,2,1,1,124,124,124,124,0,1
648,665,18,18,1,1,0,18,1,1,1,1,20,20,20,20,0,0,0,0,2,1,1,137,137,137,137,0,1
143,145,3,6,0,0,3,4.5,0.3606557377,0.5901639344,0,0.393442623,6,3,3,6,3,0,0,0,2,1,1,61,54,54,61,7,0
105,109,5,7,0,0,2,6,0.3272727273,0.5818181818,0,0.4727272727,7,5,5,7,2,0,0,0,2,1,1,55,53,53,55,2,0
193,228,36,36,0.9677419355,1,0,36,0.996031746,1,1,1,31,31,31,31,0,4,4,8,6,3,3,252,252,252,252,0,0
881,898,11,18,0.2,0.25,7,14.5,0.3,0.4384615385,0.2,0.3384615385,13,20,13,20,7,0,0,0,2,1,1,79,130,79,130,51,0
855,888,27,34,0.1176470588,0.1470588235,7,30.5,0.2695035461,0.4822695035,0.1176470588,0.3191489362,27,34,27,34,7,0,0,0,2,1,1,190,282,190,282,92,0
311,326,16,16,1,1,0,16,1,1,1,1,17,17,17,17,0,0,0,0,2,1,1,108,108,108,108,0,1
55,73,19,19,0.7894736842,1,0,19,0.9754601227,1,1,1,19,19,19,19,0,0,0,0,2,1,1,163,163,163,163,0,1
232,245,14,14,1,1,0,14,1,1,1,1,14,14,14,14,0,0,0,0,2,1,1,107,107,107,107,0,1
286,292,7,7,0.5714285714,0.7142857143,0,7,0.6304347826,0.7391304348,0.4285714286,0.6086956522,7,7,7,7,0,0,0,0,2,1,1,34,46,34,46,12,0
311,345,35,35,0.9428571429,0.9428571429,0,35,0.9579831933,0.9579831933,0.5428571429,0.8529411765,35,35,35,35,0,0,0,0,2,1,1,228,238,228,238,10,1
474,483,10,10,1,1,0,10,1,1,1,1,11,11,11,11,0,0,0,0,2,1,1,78,78,78,78,0,1
793,825,33,35,0.7272727273,0.8787878788,2,34,0.9489795918,0.9795918367,0.8787878788,0.9795918367,33,31,31,33,2,1,1,2,4,2,2,195,196,195,196,1,1
149,157,9,9,1,1,0,9,1,1,1,1,11,11,11,11,0,0,0,0,2,1,1,105,105,105,105,0,1
1133,1148,16,22,0.1818181818,0.2272727273,6,19,0.3816793893,0.5648854962,0.1818181818,0.4427480916,22,16,16,22,6,0,0,0,2,1,1,131,96,96,131,35,0
459,472,14,14,1,1,0,14,1,1,1,1,14,14,14,14,0,0,0,0,2,1,1,128,128,128,128,0,1
369,379,11,12,0.5833333333,0.9166666667,1,11.5,0.8859649123,0.9210526316,0.3333333333,0.7719298246,12,11,11,12,1,0,0,0,2,1,1,114,105,105,114,9,1
409,443,35,37,0.8974358974,0.8974358974,2,36,0.9074733096,0.9110320285,0.8974358974,0.9039145907,39,36,36,39,3,0,0,0,2,1,1,281,260,260,281,21,1
10,45,1,36,0.0384615385,0.0384615385,35,18.5,0.9333036905,0.9333036905,0.0384615385,0.9333036905,1,26,1,26,25,0,1,1,0,0,0,2099,2249,2099,2249,150,0
67,71,5,5,0.8,1,0,5,0.9855072464,1,1,1,5,5,5,5,0,0,0,0,2,1,1,69,69,69,69,0,1
7,168,162,162,1,1,0,162,1,1,1,1,157,157,157,157,0,0,0,0,0,0,0,1312,1312,1312,1312,0,1
478,493,16,16,0.875,1,0,16,0.9404761905,1,1,1,16,16,16,16,0,0,0,0,2,1,1,84,84,84,84,0,1
390,400,11,11,0.9090909091,0.9090909091,0,11,0.9090909091,0.9090909091,0.9090909091,0.9090909091,11,11,11,11,0,0,0,0,2,1,1,55,55,55,55,0,1
24,69,46,46,1,1,0,46,1,1,1,1,40,40,40,40,0,0,0,0,0,0,0,276,276,276,276,0,1
438,463,26,26,1,1,0,26,1,1,1,1,26,26,26,26,0,0,0,0,2,1,1,182,182,182,182,0,1
78,94,16,17,0.1176470588,0.1176470588,1,16.5,0.2875816993,0.5032679739,0.1176470588,0.3464052288,16,17,16,17,1,0,0,0,2,1,1,109,153,109,153,44,0
26,33,8,9,0.2222222222,0.2222222222,1,8.5,0.4927536232,0.6086956522,0.1111111111,0.4492753623,9,9,9,9,0,1,0,1,2,1,1,69,67,67,69,2,0
200,214,15,15,1,1,0,15,1,1,1,1,15,15,15,15,0,0,0,0,2,1,1,67,67,67,67,0,1
191,234,44,44,0.9777777778,1,0,44,0.9947916667,1,1,1,45,45,45,45,0,1,1,2,2,1,1,384,384,384,384,0,1
151,154,4,5,0,0,1,4.5,0.3888888889,0.6111111111,0,0.4305555556,7,5,5,7,2,2,1,3,2,1,1,72,69,69,72,3,0
102,109,7,8,0.375,0.75,1,7.5,0.4489795918,0.5510204082,0.625,0.4897959184,7,8,7,8,1,0,0,0,2,1,1,27,49,27,49,22,0
1066,1077,12,12,0.9230769231,0.9230769231,0,12,0.9833333333,0.9916666667,0.8461538462,0.975,13,13,13,13,0,0,0,0,2,1,1,120,120,120,120,0,0
1016,1030,10,15,0.2,0.3333333333,5,12.5,0.4029850746,0.6119402985,0.3333333333,0.5223880597,10,15,10,15,5,0,0,0,2,1,1,53,67,53,67,14,0
583,590,8,8,1,1,0,8,1,1,1,1,9,9,9,9,0,1,1,2,2,1,1,52,52,52,52,0,1
68,84,17,17,0.4117647059,0.7058823529,0,17,0.5918367347,0.7653061224,0.4117647059,0.6224489796,17,17,17,17,0,0,0,0,2,1,1,84,98,84,98,14,0
874,900,27,27,0.9259259259,1,0,27,0.9896373057,1,1,1,27,27,27,27,0,0,0,0,2,1,1,193,193,193,193,0,1
152,204,53,53,1,1,0,53,1,1,1,1,50,50,50,50,0,1,1,2,2,1,1,324,324,324,324,0,0
205,216,12,12,0.5833333333,0.9166666667,0,12,0.8515625,0.9296875,0.5,0.8203125,12,12,12,12,0,0,0,0,2,1,1,119,128,119,128,9,0
536,562,27,27,1,1,0,27,1,1,1,1,27,27,27,27,0,0,0,0,2,1,1,464,464,464,464,0,1
477,498,22,22,1,1,0,22,1,1,1,1,22,22,22,22,0,0,0,0,2,1,1,154,154,154,154,0,0
710,719,10,12,0.5,0.7142857143,2,11,0.6761904762,0.7619047619,0.2142857143,0.5904761905,14,12,12,14,2,0,0,0,2,1,1,105,90,90,105,15,0
69,89,21,21,0,0,0,21,0.0227272727,0.75,0,0.4090909091,11,11,11,11,0,0,0,0,0,0,0,44,44,44,44,0,0
667,675,9,9,0.8888888889,0.8888888889,0,9,0.9824561404,0.9824561404,0.8888888889,0.9824561404,9,9,9,9,0,1,0,1,2,1,1,112,114,112,114,2,1
10,10,1,28,0.0434782609,0.0434782609,27,14.5,0.9421005386,0.9421005386,0.0434782609,0.9421005386,23,1,1,23,22,1,0,1,1,1,0,2228,2099,2099,2228,129,0
128,139,12,12,0.9166666667,0.9166666667,0,12,0.9426229508,0.9508196721,0.25,0.7540983607,12,12,12,12,0,0,0,0,2,1,1,122,116,116,122,6,1
11,22,12,12,0.9285714286,0.9285714286,0,12,0.992481203,0.992481203,0.9285714286,0.992481203,14,14,14,14,0,0,0,0,2,1,1,133,133,133,133,0,1
14,23,10,12,0.1666666667,0.25,2,11,0.3258426966,0.5168539326,0.1666666667,0.4382022472,12,10,10,12,2,0,0,0,2,1,1,89,58,58,89,31,0
115,125,11,11,1,1,0,11,1,1,1,1,12,12,12,12,0,0,0,0,2,1,1,83,83,83,83,0,1
229,251,23,23,1,1,0,23,1,1,1,1,22,22,22,22,0,0,0,0,4,2,2,141,141,141,141,0,1
506,524,19,19,1,1,0,19,1,1,1,1,20,20,20,20,0,0,0,0,2,1,1,235,235,235,235,0,1
50,61,12,12,1,1,0,12,1,1,1,1,12,12,12,12,0,0,0,0,2,1,1,83,83,83,83,0,1
1165,1174,10,10,0.7,0.7,0,10,0.6455696203,0.6708860759,0.5,0.5949367089,10,10,10,10,0,0,0,0,2,1,1,79,53,53,79,26,1
114,118,5,5,0.6666666667,1,0,5,0.9677419355,1,1,1,6,6,6,6,0,2,2,4,2,1,1,62,62,62,62,0,0
371,387,17,17,1,1,0,17,1,1,1,1,17,17,17,17,0,3,3,6,2,1,1,153,153,153,153,0,1
137,140,4,10,0,0,6,7,0.3965517241,0.6379310345,0,0.5,9,4,4,9,5,1,1,2,3,2,1,55,58,55,58,3,0
573,587,15,15,0.8666666667,1,0,15,0.9863945578,1,1,1,15,15,15,15,0,0,0,0,2,1,1,147,147,147,147,0,1
327,406,80,80,0,1,0,80,0.5714285714,1,1,1,80,80,80,80,0,0,0,0,2,1,1,560,560,560,560,0,0
744,759,16,20,0.3,0.6,4,18,0.6299559471,0.718061674,0.25,0.5947136564,20,16,16,20,4,0,0,0,2,1,1,227,163,163,227,64,0
38,45,8,9,0.5555555556,0.6666666667,1,8.5,0.8387096774,0.8548387097,0.6666666667,0.8548387097,9,9,9,9,0,0,0,0,2,1,1,62,62,62,62,0,0
255,271,15,17,0.3529411765,0.8823529412,2,16,0.8258426966,0.9213483146,0.6470588235,0.8876404494,15,17,15,17,2,0,0,0,2,1,1,164,178,164,178,14,1
11,21,11,11,0.5833333333,1,0,11,0.9212598425,1,1,1,12,12,12,12,0,1,1,2,2,1,1,127,127,127,127,0,0
234,252,19,19,0.1052631579,0.1578947368,0,19,0.349112426,0.5917159763,0.1052631579,0.4142011834,19,19,19,19,0,0,0,0,2,1,1,155,169,155,169,14,1
348,365,16,18,0.3333333333,0.8888888889,2,17,0.8162162162,0.9243243243,0.6666666667,0.8918918919,16,18,16,18,2,0,0,0,2,1,1,171,185,171,185,14,1
121,127,7,7,0.625,0.875,0,7,0.8421052632,0.8947368421,0.375,0.6578947368,8,8,8,8,0,1,1,2,2,1,1,68,76,68,76,8,0
14,34,21,21,1,1,0,21,1,1,1,1,14,14,14,14,0,2,2,4,2,1,1,73,73,73,73,0,1
684,722,39,39,0.9512195122,0.9512195122,0,39,0.9956043956,0.9956043956,0.9512195122,0.9956043956,41,41,41,41,0,0,0,0,2,1,1,455,455,455,455,0,1
14,25,10,12,0,0.2222222222,2,11,0.4054054054,0.7027027027,0,0.5540540541,6,9,6,9,3,1,1,2,0,0,0,60,74,60,74,14,0
332,353,13,22,0.1111111111,0.3333333333,9,17.5,0.425,0.75,0.1111111111,0.55,9,9,9,9,0,1,1,2,2,1,1,40,40,40,40,0,0
1035,1043,9,9,0.5,0.75,0,9,0.7407407407,0.7962962963,0.75,0.7777777778,13,16,13,16,3,1,1,2,4,2,2,88,108,88,108,20,0
321,327,7,7,0.4285714286,0.8571428571,0,7,0.8,0.9666666667,0.5714285714,0.8666666667,7,7,7,7,0,0,0,0,3,1,2,29,30,29,30,1,0
60,74,15,15,1,1,0,15,1,1,1,1,8,8,8,8,0,0,0,0,0,0,0,94,94,94,94,0,1
17,33,17,33,0,0.5714285714,16,25,0.4634146341,0.6829268293,0.1428571429,0.5243902439,7,7,7,7,0,2,2,4,2,1,1,60,82,60,82,22,0
1097,1105,4,9,0,0,5,6.5,0.2261904762,0.4047619048,0,0.2976190476,4,9,4,9,5,1,1,2,2,1,1,51,84,51,84,33,0
207,214,8,8,0,0.5,0,8,0.5714285714,0.9285714286,0,0.75,8,8,8,8,0,0,0,0,2,1,1,56,56,56,56,0,0
104,114,11,12,0,0.1666666667,1,11.5,0.4059405941,0.6831683168,0,0.504950495,12,11,11,12,1,3,1,4,2,1,1,101,85,85,101,16,0
118,128,11,11,0.9230769231,0.9230769231,0,11,0.9807692308,0.9807692308,0.9230769231,0.9807692308,13,13,13,13,0,0,0,0,2,1,1,104,102,102,104,2,1
1381,1387,7,7,0.5714285714,0.8571428571,0,7,0.8039215686,0.862745098,0.5714285714,0.7843137255,7,7,7,7,0,0,0,0,2,1,1,51,44,44,51,7,1
416,423,6,8,0,0.125,2,7,0.3424657534,0.5753424658,0,0.4383561644,6,8,6,8,2,0,0,0,2,1,1,43,73,43,73,30,0
95,101,7,7,0.875,1,0,7,0.9852941176,1,1,1,8,8,8,8,0,1,1,2,2,1,1,68,68,68,68,0,1
546,570,25,25,0.8461538462,1,0,25,0.9759615385,1,1,1,26,26,26,26,0,1,1,2,4,2,2,208,208,208,208,0,1
206,217,12,12,0.5,0.9166666667,0,12,0.8655462185,0.974789916,0.9166666667,0.8991596639,12,12,12,12,0,0,0,0,2,1,1,119,118,118,119,1,1
186,195,10,10,0.9,1,0,10,0.9677419355,1,1,1,10,10,10,10,0,0,0,0,2,1,1,62,62,62,62,0,1
1,68,68,68,1,1,0,68,1,1,1,1,47,47,47,47,0,0,0,0,0,0,0,325,325,325,325,0,1
112,118,7,7,0.625,0.875,0,7,0.8481012658,0.8987341772,0.25,0.6455696203,8,8,8,8,0,0,0,0,2,1,1,79,71,71,79,8,1
48,64,14,17,0.1764705882,0.2352941176,3,15.5,0.3949579832,0.6302521008,0.2352941176,0.4621848739,14,17,14,17,3,0,0,0,2,1,1,105,119,105,119,14,0
13,30,18,18,1,1,0,18,1,1,1,1,18,18,18,18,0,0,0,0,2,1,1,113,113,113,113,0,1
144,160,17,17,0.7368421053,1,0,17,0.9696969697,1,1,1,19,19,19,19,0,1,1,2,2,1,1,165,165,165,165,0,1
4,205,202,202,1,1,0,202,1,1,1,1,183,183,183,183,0,0,0,0,0,0,0,1536,1536,1536,1536,0,0
301,404,104,139,0.8666666667,0.9333333333,35,121.5,0.9849056604,0.9924528302,0.9333333333,0.9924528302,30,30,30,30,0,0,0,0,4,2,2,263,265,263,265,2,1
1411,1428,18,18,1,1,0,18,1,1,1,1,18,18,18,18,0,2,2,4,2,1,1,67,67,67,67,0,1
8,29,22,24,0.6538461538,0.8461538462,2,23,0.7957446809,0.8510638298,0.6923076923,0.8,26,23,23,26,3,0,0,0,2,1,1,235,200,200,235,35,1
202,265,64,64,1,1,0,64,1,1,1,1,64,64,64,64,0,0,0,0,2,1,1,511,511,511,511,0,1
132,163,32,32,1,1,0,32,1,1,1,1,33,33,33,33,0,0,0,0,2,1,1,235,235,235,235,0,1
127,149,23,23,1,1,0,23,1,1,1,1,25,25,25,25,0,0,0,0,2,1,1,202,202,202,202,0,1
36,45,7,10,0,0.0909090909,3,8.5,0.3157894737,0.5657894737,0,0.3815789474,7,11,7,11,4,2,0,2,2,1,1,56,76,56,76,20,0
130,137,8,8,1,1,0,8,1,1,1,1,8,8,8,8,0,0,0,0,2,1,1,71,71,71,71,0,1
414,493,80,80,1,1,0,80,1,1,1,1,80,80,80,80,0,0,0,0,2,1,1,560,560,560,560,0,0
1209,1218,10,10,1,1,0,10,1,1,1,1,10,10,10,10,0,0,0,0,2,1,1,61,61,61,61,0,1
280,289,10,10,0.9090909091,0.9090909091,0,10,0.9847328244,0.9847328244,0.9090909091,0.9847328244,11,11,11,11,0,0,0,0,2,1,1,131,129,129,131,2,1
159,226,68,68,1,1,0,68,1,1,1,1,70,70,70,70,0,0,0,0,2,1,1,635,635,635,635,0,1
39,42,4,4,0,1,0,4,0.9078947368,1,0.75,0.9736842105,4,4,4,4,0,0,0,0,2,1,1,76,76,76,76,0,1
687,699,10,13,0.0714285714,0.5,3,11.5,0.8108108108,0.9369369369,0.4285714286,0.8648648649,11,14,11,14,3,1,0,1,2,1,1,111,111,111,111,0,0
381,392,12,12,1,1,0,12,1,1,1,1,14,14,14,14,0,0,0,0,2,1,1,124,124,124,124,0,1
101,110,10,10,0.8,1,0,10,0.96875,1,1,1,10,10,10,10,0,0,0,0,2,1,1,64,64,64,64,0,1
443,453,11,11,1,1,0,11,1,1,1,1,11,11,11,11,0,0,0,0,2,1,1,87,87,87,87,0,1
575,587,13,13,0.8461538462,1,0,13,0.9805825243,1,1,1,13,13,13,13,0,2,2,4,2,1,1,103,103,103,103,0,0
652,665,14,14,0.8666666667,0.9333333333,0,14,0.9285714286,0.9523809524,0.5333333333,0.7976190476,15,15,15,15,0,3,2,5,2,1,1,84,80,80,84,4,1
651,656,6,6,1,1,0,6,1,1,1,1,8,8,8,8,0,0,0,0,2,1,1,71,71,71,71,0,1
108,124,17,17,0.7368421053,1,0,17,0.9696969697,1,1,1,19,19,19,19,0,1,1,2,2,1,1,165,165,165,165,0,1
424,436,13,15,0.4666666667,0.8,2,14,0.6979865772,0.7651006711,0.3333333333,0.6375838926,15,13,13,15,2,0,0,0,2,1,1,149,114,114,149,35,0
48,719,672,672,1,1,0,672,1,1,1,1,576,576,576,576,0,0,0,0,0,0,0,4906,4906,4906,4906,0,1
86,96,11,17,0.3125,0.625,6,14,0.6134453782,0.6806722689,0.5625,0.6722689076,16,10,10,16,6,2,2,4,4,2,2,119,81,81,119,38,0
476,493,18,18,0.3333333333,0.8333333333,0,18,0.6082474227,0.8453608247,0.2222222222,0.5360824742,18,18,18,18,0,0,0,0,2,1,1,185,194,185,194,9,1
165,171,7,7,0.625,1,0,7,0.9210526316,1,1,1,8,8,8,8,0,1,1,2,2,1,1,76,76,76,76,0,1
104,114,10,11,0.3636363636,0.7272727273,1,10.5,0.6666666667,0.7916666667,0.3636363636,0.6388888889,10,11,10,11,1,0,0,0,2,1,1,65,72,65,72,7,1
1083,1095,13,14,0.6428571429,0.9285714286,1,13.5,0.8852459016,0.9262295082,0.4285714286,0.8114754098,14,13,13,14,1,0,0,0,2,1,1,122,113,113,122,9,1
648,665,18,21,0.7391304348,0.7826086957,3,19.5,0.7951807229,0.813253012,0.347826087,0.656626506,23,20,20,23,3,0,0,0,2,1,1,166,137,137,166,29,1
1109,1117,9,9,1,1,0,9,1,1,1,1,10,10,10,10,0,0,0,0,2,1,1,70,70,70,70,0,1
178,183,6,7,0.5714285714,0.7142857143,1,6.5,0.8378378378,0.8648648649,0.5714285714,0.8513513514,7,6,6,7,1,0,0,0,2,1,1,74,64,64,74,10,1
679,703,25,27,0.8518518519,0.8518518519,2,26,0.9113924051,0.9240506329,0.8518518519,0.9240506329,27,25,25,27,2,0,0,0,2,1,1,158,156,156,158,2,1
304,314,11,14,0.625,0.6875,3,12.5,0.6147540984,0.6639344262,0.375,0.5163934426,16,13,13,16,3,0,0,0,2,1,1,122,93,93,122,29,1
275,289,15,15,0.8666666667,0.8666666667,0,15,0.9072164948,0.9072164948,0.2666666667,0.6907216495,15,15,15,15,0,1,1,2,2,1,1,92,97,92,97,5,1
42,50,9,9,0.8888888889,0.8888888889,0,9,0.7272727273,0.7532467532,0.8888888889,0.7402597403,9,9,9,9,0,0,0,0,2,1,1,58,77,58,77,19,1
56,62,7,7,0.2857142857,0.8571428571,0,7,0.7692307692,0.9076923077,0.8571428571,0.8769230769,7,7,7,7,0,0,0,0,2,1,1,65,62,62,65,3,1
73,82,10,10,1,1,0,10,1,1,1,1,10,10,10,10,0,0,0,0,2,1,1,62,62,62,62,0,1
30,42,13,13,0.9230769231,1,0,13,0.9880952381,1,1,1,13,13,13,13,0,0,0,0,2,1,1,84,84,84,84,0,1
762,773,12,12,0.75,1,0,12,0.9722222222,1,1,1,12,12,12,12,0,0,0,0,2,1,1,108,108,108,108,0,1
1266,1363,98,98,1,1,0,98,1,1,1,1,75,75,75,75,0,1,1,2,4,2,2,599,599,599,599,0,0
113,122,10,15,0.375,0.4375,5,12.5,0.7592592593,0.8024691358,0.125,0.5740740741,16,11,11,16,5,0,0,0,2,1,1,162,141,141,162,21,1
220,231,12,12,0.5833333333,0.9166666667,0,12,0.8559322034,0.9152542373,0.3333333333,0.7542372881,12,12,12,12,0,0,0,0,2,1,1,112,118,112,118,6,1
59,71,13,13,1,1,0,13,1,1,1,1,13,13,13,13,0,0,0,0,2,1,1,60,60,60,60,0,1
162,170,9,9,1,1,0,9,1,1,1,1,11,11,11,11,0,0,0,0,2,1,1,72,72,72,72,0,1
754,773,20,20,0.6666666667,0.9047619048,0,20,0.8467741935,0.9112903226,0.9047619048,0.9112903226,21,21,21,21,0,0,0,0,2,1,1,124,114,114,124,10,1
32,51,20,21,0.619047619,0.8095238095,1,20.5,0.7567567568,0.8378378378,0.380952381,0.722972973,21,20,20,21,1,0,0,0,2,1,1,148,133,133,148,15,1
355,366,12,12,0.9166666667,1,0,12,0.9818181818,1,1,1,12,12,12,12,0,0,0,0,4,2,2,55,55,55,55,0,1
1026,1032,7,7,1,1,0,7,1,1,1,1,9,9,9,9,0,0,0,0,2,1,1,66,66,66,66,0,1
432,453,22,22,1,1,0,22,1,1,1,1,22,22,22,22,0,0,0,0,2,1,1,154,154,154,154,0,1
87,97,9,11,0.2727272727,0.7272727273,2,10,0.6222222222,0.7777777778,0.5454545455,0.6888888889,9,11,9,11,2,0,0,0,2,1,1,41,45,41,45,4,0
33,38,6,7,0.4285714286,0.7142857143,1,6.5,0.59375,0.78125,0.4285714286,0.71875,7,6,6,7,1,0,0,0,2,1,1,32,27,27,32,5,0
547,556,5,10,0,0,5,7.5,0.3417721519,0.5696202532,0,0.417721519,5,9,5,9,4,0,1,1,3,1,2,64,79,64,79,15,0
55,64,10,10,1,1,0,10,1,1,1,1,10,10,10,10,0,0,0,0,2,1,1,56,56,56,56,0,1
1209,1272,64,127,0,0,63,95.5,0.001953125,0.25,0,0.00390625,64,64,64,64,0,0,0,0,1,0,1,512,448,448,512,64,0
364,382,19,19,0.9473684211,0.9473684211,0,19,0.9777777778,0.9777777778,0.9473684211,0.9777777778,19,19,19,19,0,1,2,3,2,1,1,90,88,88,90,2,1
202,252,51,51,1,1,0,51,1,1,1,1,48,48,48,48,0,1,1,2,4,2,2,322,322,322,322,0,1
904,910,7,7,0,0.8571428571,0,7,0.7272727273,0.9636363636,0.8571428571,0.9636363636,7,7,7,7,0,1,1,2,2,1,1,55,55,55,55,0,0
557,569,13,13,1,1,0,13,1,1,1,1,13,13,13,13,0,2,2,4,2,1,1,82,82,82,82,0,1
541,563,18,23,0.68,0.72,5,20.5,0.7165775401,0.7326203209,0.32,0.5989304813,20,25,20,25,5,0,0,0,2,1,1,137,187,137,187,50,1
348,353,6,6,0.3333333333,0.8333333333,0,6,0.72,0.96,0.8333333333,0.92,6,6,6,6,0,0,0,0,2,1,1,24,25,24,25,1,0
86,102,17,17,0.7058823529,0.7647058824,0,17,0.8503937008,0.8661417323,0.2352941176,0.6614173228,17,17,17,17,0,0,0,0,2,1,1,127,118,118,127,9,1
415,428,14,14,1,1,0,14,1,1,1,1,14,14,14,14,0,2,2,4,2,1,1,168,168,168,168,0,1
678,685,8,8,0.8888888889,1,0,8,0.9807692308,1,1,1,9,9,9,9,0,1,1,2,2,1,1,52,52,52,52,0,1
629,646,18,21,0.7391304348,0.7826086957,3,19.5,0.7951807229,0.813253012,0.347826087,0.656626506,23,20,20,23,3,0,0,0,2,1,1,166,137,137,166,29,1
181,200,20,21,0.8095238095,0.8571428571,1,20.5,0.875,0.9,0.8571428571,0.9,21,20,20,21,1,0,0,0,2,1,1,160,144,144,160,16,1
64,68,5,5,0.8,1,0,5,0.984375,1,1,1,5,5,5,5,0,0,0,0,2,1,1,64,64,64,64,0,1
428,448,21,23,0.84,0.88,2,22,0.8395721925,0.871657754,0.68,0.807486631,25,23,23,25,2,0,0,0,2,1,1,187,166,166,187,21,1
228,237,10,12,0.4166666667,0.5,2,11,0.4473684211,0.6052631579,0.3333333333,0.5,12,10,10,12,2,0,0,0,2,1,1,76,52,52,76,24,0
363,383,21,23,0.3043478261,0.652173913,2,22,0.5535714286,0.7410714286,0.3043478261,0.5803571429,23,21,21,23,2,0,0,0,2,1,1,112,109,109,112,3,0
245,256,12,12,1,1,0,12,1,1,1,1,12,12,12,12,0,0,0,0,2,1,1,96,96,96,96,0,1
229,235,7,7,0,1,0,7,0.6666666667,1,1,1,7,7,7,7,0,0,0,0,0,0,0,63,63,63,63,0,0
305,316,12,12,0.0833333333,0.9166666667,0,12,0.7872340426,0.914893617,0.9166666667,0.9042553191,12,12,12,12,0,0,0,0,2,1,1,89,94,89,94,5,1
113,124,12,12,1,1,0,12,1,1,1,1,12,12,12,12,0,0,0,0,2,1,1,67,67,67,67,0,1
162,171,10,11,0.7692307692,0.7692307692,1,10.5,0.8181818182,0.8282828283,0.2307692308,0.6262626263,13,12,12,13,1,0,0,0,2,1,1,99,82,82,99,17,1
202,235,34,34,1,1,0,34,1,1,1,1,34,34,34,34,0,1,1,2,4,2,2,243,243,243,243,0,1
306,344,39,39,1,1,0,39,1,1,1,1,39,39,39,39,0,0,0,0,2,1,1,297,297,297,297,0,1
112,122,11,11,0.2727272727,0.3636363636,0,11,0.3625,0.5375,0.2727272727,0.3625,11,11,11,11,0,0,0,0,2,1,1,80,63,63,80,17,0
840,846,7,7,1,1,0,7,1,1,1,1,7,7,7,7,0,0,0,0,2,1,1,35,35,35,35,0,1
347,378,32,32,0,0,0,32,0.4285714286,0.5714285714,0,0.4375,32,32,32,32,0,0,0,0,2,1,1,160,224,160,224,64,0
60,74,15,15,1,1,0,15,1,1,1,1,8,8,8,8,0,0,0,0,0,0,0,94,94,94,94,0,1
226,235,10,10,0.5,0.7,0,10,0.6444444444,0.8,0.7,0.7555555556,10,10,10,10,0,0,0,0,2,1,1,45,39,39,45,6,1
561,568,8,8,0.8888888889,1,0,8,0.9807692308,1,1,1,9,9,9,9,0,1,1,2,2,1,1,52,52,52,52,0,1
452,473,22,22,1,1,0,22,1,1,1,1,22,22,22,22,0,0,0,0,2,1,1,154,154,154,154,0,0
56,67,10,12,0.1666666667,0.25,2,11,0.48,0.67,0.1666666667,0.49,10,12,10,12,2,0,0,0,2,1,1,83,100,83,100,17,0
146,176,31,31,0.0967741935,0.1612903226,0,31,0.4296875,0.65234375,0.0967741935,0.484375,31,31,31,31,0,0,0,0,2,1,1,256,256,256,256,0,0
29,53,23,25,0.04,0.76,2,24,0.5602409639,0.8614457831,0.04,0.6445783133,23,25,23,25,2,0,0,0,2,1,1,156,166,156,166,10,1
35,35,1,1,0,0,0,1,0.9995224451,0.9995224451,0,0.9995224451,1,1,1,1,0,0,0,0,0,0,0,2094,2094,2094,2094,0,0
133,146,12,14,0.5,0.8571428571,2,13,0.7793103448,0.8137931034,0.5,0.7931034483,12,14,12,14,2,0,0,0,2,1,1,118,145,118,145,27,1
237,247,11,11,0.7272727273,0.9090909091,0,11,0.8727272727,0.9272727273,0.4545454545,0.7818181818,11,11,11,11,0,0,0,0,2,1,1,51,55,51,55,4,1
222,249,28,28,1,1,0,28,1,1,1,1,29,29,29,29,0,2,2,4,2,1,1,326,326,326,326,0,1
80,104,25,25,0.8214285714,1,0,25,0.979338843,1,1,1,28,28,28,28,0,1,1,2,2,1,1,242,242,242,242,0,1
19,28,10,10,1,1,0,10,1,1,1,1,10,10,10,10,0,0,0,0,2,1,1,94,94,94,94,0,1
436,451,16,16,0.75,1,0,16,0.9714285714,1,1,1,16,16,16,16,0,4,4,8,2,1,1,175,175,175,175,0,1
299,329,31,31,1,1,0,31,1,1,1,1,31,31,31,31,0,0,0,0,2,1,1,217,217,217,217,0,1
667,685,19,23,0.68,0.72,4,21,0.7326203209,0.7754010695,0.32,0.6256684492,25,21,21,25,4,0,0,0,2,1,1,187,149,149,187,38,1
30,44,15,15,1,1,0,15,1,1,1,1,15,15,15,15,0,0,0,0,2,1,1,72,72,72,72,0,1
960,971,12,14,0.5714285714,0.7857142857,2,13,0.8017241379,0.8620689655,0.7142857143,0.8275862069,14,12,12,14,2,0,0,0,2,1,1,116,101,101,116,15,1
363,388,26,26,1,1,0,26,1,1,1,1,26,26,26,26,0,0,0,0,2,1,1,182,182,182,182,0,0
460,492,33,33,1,1,0,33,1,1,1,1,33,33,33,33,0,0,0,0,2,1,1,243,243,243,243,0,1
648,665,18,21,0.7391304348,0.7826086957,3,19.5,0.7951807229,0.813253012,0.347826087,0.656626506,23,20,20,23,3,0,0,0,2,1,1,166,137,137,166,29,1
1027,1035,9,9,1,1,0,9,1,1,1,1,9,9,9,9,0,2,2,4,2,1,1,63,63,63,63,0,1
140,148,7,9,0,0,2,8,0.3,0.5166666667,0,0.3666666667,8,9,8,9,1,0,1,1,2,1,1,51,60,51,60,9,0
451,474,24,24,1,1,0,24,1,1,1,1,24,24,24,24,0,0,0,0,2,1,1,168,168,168,168,0,1
84,100,17,17,0.7368421053,1,0,17,0.9696969697,1,1,1,19,19,19,19,0,1,1,2,2,1,1,165,165,165,165,0,1
748,765,16,18,0.1666666667,0.1666666667,2,17,0.36,0.57,0.1666666667,0.4,16,18,16,18,2,0,0,0,2,1,1,100,98,98,100,2,0
373,379,7,7,0.7142857143,1,0,7,0.9718309859,1,1,1,7,7,7,7,0,1,1,2,2,1,1,71,71,71,71,0,1
476,485,10,10,1,1,0,10,1,1,1,1,11,11,11,11,0,0,0,0,2,1,1,78,78,78,78,0,1
259,266,8,8,0.125,0.75,0,8,0.7101449275,0.9130434783,0.625,0.884057971,8,8,8,8,0,1,0,1,2,1,1,65,69,65,69,4,1
513,528,16,16,0.875,1,0,16,0.9833333333,1,1,1,16,16,16,16,0,2,2,4,2,1,1,120,120,120,120,0,1
490,499,10,11,0.7692307692,0.7692307692,1,10.5,0.8282828283,0.8383838384,0.2307692308,0.6262626263,13,12,12,13,1,0,0,0,2,1,1,99,83,83,99,16,0
145,179,35,35,0.7428571429,0.9714285714,0,35,0.9435736677,0.9968652038,0.2857142857,0.7210031348,35,35,35,35,0,0,0,0,2,1,1,318,319,318,319,1,1
373,392,10,20,0.15,0.2,10,15,0.276119403,0.447761194,0.15,0.3432835821,11,20,11,20,9,0,0,0,2,1,1,78,134,78,134,56,0
331,350,20,20,1,1,0,20,1,1,1,1,23,23,23,23,0,0,0,0,2,1,1,269,269,269,269,0,1
240,256,10,17,0.1764705882,0.1764705882,7,13.5,0.347826087,0.5326086957,0.1764705882,0.4456521739,10,17,10,17,7,0,0,0,2,1,1,83,92,83,92,9,0
62,78,17,17,0.6315789474,0.9473684211,0,17,0.9075144509,0.9537572254,0.8421052632,0.9421965318,19,19,19,19,0,1,1,2,2,1,1,165,173,165,173,8,1
200,214,15,17,0.7647058824,0.8235294118,2,16,0.845814978,0.8634361233,0.7647058824,0.8546255507,17,15,15,17,2,0,0,0,2,1,1,227,198,198,227,29,1
199,222,23,24,0.25,0.4583333333,1,23.5,0.3661971831,0.5704225352,0.25,0.4366197183,23,24,23,24,1,0,0,0,2,1,1,142,120,120,142,22,0
432,434,3,3,0.6666666667,1,0,3,0.95,1,1,1,6,6,6,6,0,0,0,0,2,1,1,40,40,40,40,0,0
874,885,11,12,0.6666666667,0.75,1,11.5,0.5031847134,0.5732484076,0.4166666667,0.4458598726,11,12,11,12,1,0,0,0,3,2,1,92,157,92,157,65,0
555,576,22,22,0,0,0,22,0.4444444444,0.6666666667,0,0.6666666667,22,22,22,22,0,0,0,0,1,0,1,198,154,154,198,44,0
342,400,59,59,0.9818181818,0.9818181818,0,59,0.9771428571,0.9828571429,0.3454545455,0.7057142857,55,55,55,55,0,3,3,6,2,1,1,350,348,348,350,2,0
58,70,13,22,0.1818181818,0.1818181818,9,17.5,0.2682926829,0.4451219512,0.1818181818,0.3048780488,22,14,14,22,8,0,0,0,2,1,1,164,99,99,164,65,0
975,999,25,25,0.72,1,0,25,0.9481481481,1,1,1,25,25,25,25,0,0,0,0,2,1,1,135,135,135,135,0,1
265,276,12,12,1,1,0,12,1,1,1,1,14,14,14,14,0,0,0,0,2,1,1,124,124,124,124,0,1
610,618,8,9,0.7272727273,0.7272727273,1,8.5,0.76,0.8,0.2727272727,0.6,10,11,10,11,1,0,0,0,2,1,1,62,75,62,75,13,1
14,26,13,13,0.7692307692,0.9230769231,0,13,0.9252336449,0.9439252336,0.9230769231,0.9439252336,13,13,13,13,0,2,1,3,2,1,1,101,107,101,107,6,1
648,665,18,18,1,1,0,18,1,1,1,1,20,20,20,20,0,0,0,0,2,1,1,137,137,137,137,0,1
62,79,18,18,1,1,0,18,1,1,1,1,18,18,18,18,0,1,1,2,2,1,1,117,117,117,117,0,1
139,193,55,55,1,1,0,55,1,1,1,1,55,55,55,55,0,0,0,0,2,1,1,351,351,351,351,0,1
158,183,26,26,0.9655172414,0.9655172414,0,26,0.9677419355,0.9758064516,0.1034482759,0.7096774194,29,29,29,29,0,1,1,2,2,1,1,248,246,246,248,2,0
25,31,6,7,0.1428571429,0.7142857143,1,6.5,0.5,0.8,0.5714285714,0.74,6,7,6,7,1,0,0,0,2,1,1,41,50,41,50,9,0
655,676,22,22,0.8846153846,0.9230769231,0,22,0.9838709677,0.9892473118,0.6153846154,0.935483871,26,26,26,26,0,0,0,0,2,1,1,186,186,186,186,0,1
52,54,3,3,0,0.6666666667,0,3,0.8076923077,0.9230769231,0.6666666667,0.9038461538,3,3,3,3,0,0,0,0,2,1,1,52,48,48,52,4,0
320,327,8,8,0.5,0.875,0,8,0.5192307692,0.6538461538,0.5,0.5769230769,8,8,8,8,0,0,0,0,2,1,1,52,36,36,52,16,0
246,346,51,101,0,0,50,76,0.25,0.5,0,0.387254902,51,51,51,51,0,0,0,0,1,1,0,357,408,357,408,51,0
309,347,39,39,0.8974358974,0.8974358974,0,39,0.9506578947,0.9506578947,0.4615384615,0.7105263158,39,39,39,39,0,0,0,0,2,1,1,297,304,297,304,7,1
181,194,14,14,1,1,0,14,1,1,1,1,13,13,13,13,0,4,4,8,4,2,2,123,123,123,123,0,1
807,819,13,14,0.7142857143,0.8571428571,1,13.5,0.8431372549,0.8725490196,0.5714285714,0.8039215686,14,13,13,14,1,0,0,0,2,1,1,102,89,89,102,13,1
48,157,110,110,1,1,0,110,1,1,1,1,115,115,115,115,0,0,0,0,2,1,1,685,685,685,685,0,1
446,462,17,17,1,1,0,17,1,1,1,1,19,19,19,19,0,1,1,2,2,1,1,117,117,117,117,0,1
144,171,28,28,0.9375,1,0,28,0.99,1,1,1,16,16,16,16,0,0,0,0,4,2,2,100,100,100,100,0,1
200,214,15,15,1,1,0,15,1,1,1,1,15,15,15,15,0,0,0,0,2,1,1,198,198,198,198,0,1
127,145,16,19,0.7619047619,0.7619047619,3,17.5,0.7796610169,0.7853107345,0.4285714286,0.6384180791,18,21,18,21,3,0,0,0,2,1,1,140,177,140,177,37,1
461,474,13,14,0.7142857143,0.7857142857,1,13.5,0.8796992481,0.9172932331,0.5714285714,0.7969924812,13,14,13,14,1,0,0,0,2,1,1,133,128,128,133,5,1
128,144,17,17,0.5263157895,0.8947368421,0,17,0.8901734104,0.9421965318,0.7894736842,0.9306358382,19,19,19,19,0,1,1,2,2,1,1,165,173,165,173,8,0
1155,1180,26,26,1,1,0,26,1,1,1,1,26,26,26,26,0,3,3,6,2,1,1,192,192,192,192,0,1
394,482,89,89,0.9880952381,0.9880952381,0,89,0.9894514768,0.9894514768,0.9880952381,0.9894514768,84,84,84,84,0,1,1,2,2,1,1,938,948,938,948,10,0
126,138,13,13,1,1,0,13,1,1,1,1,13,13,13,13,0,0,0,0,2,1,1,111,111,111,111,0,1
61,82,22,22,0.875,1,0,22,0.9846938776,1,1,1,24,24,24,24,0,2,2,4,2,1,1,196,196,196,196,0,1
841,850,10,10,0.5,0.7,0,10,0.4736842105,0.6315789474,0.5,0.5614035088,10,10,10,10,0,0,0,0,2,1,1,57,44,44,57,13,0
24,34,11,11,0.3636363636,0.7272727273,0,11,0.5789473684,0.7631578947,0.3636363636,0.6315789474,11,11,11,11,0,0,0,0,2,1,1,75,76,75,76,1,1
428,448,18,21,0.7391304348,0.7826086957,3,19.5,0.7951807229,0.813253012,0.347826087,0.656626506,20,23,20,23,3,0,0,0,2,1,1,137,166,137,166,29,1
565,587,23,23,1,1,0,23,1,1,1,1,23,23,23,23,0,0,0,0,2,1,1,208,208,208,208,0,1
548,570,23,23,1,1,0,23,1,1,1,1,25,25,25,25,0,0,0,0,2,1,1,187,187,187,187,0,1
910,922,12,13,0.5384615385,0.8461538462,1,12.5,0.7933884298,0.9256198347,0.3076923077,0.7272727273,12,13,12,13,1,0,0,0,2,1,1,118,121,118,121,3,1
255,269,15,15,1,1,0,15,1,1,1,1,15,15,15,15,0,0,0,0,2,1,1,168,168,168,168,0,1
488,494,7,7,1,1,0,7,1,1,1,1,7,7,7,7,0,0,0,0,2,1,1,51,51,51,51,0,1
369,379,11,11,1,1,0,11,1,1,1,1,11,11,11,11,0,0,0,0,2,1,1,61,61,61,61,0,1
203,275,53,73,0.9807692308,0.9807692308,20,63,0.9872122762,0.9923273657,0.9807692308,0.989769821,52,52,52,52,0,1,1,2,4,2,2,391,388,388,391,3,1
220,234,11,15,0.25,0.8333333333,4,13,0.6779661017,0.8559322034,0.8333333333,0.8559322034,12,12,12,12,0,1,1,2,4,2,2,118,104,104,118,14,1
415,446,32,32,1,1,0,32,1,1,1,1,32,32,32,32,0,0,0,0,2,1,1,224,224,224,224,0,1
929,932,4,11,0,0,7,7.5,0.3134328358,0.5373134328,0,0.3731343284,9,4,4,9,5,0,0,0,3,2,1,67,57,57,67,10,0
46,355,310,330,0.7680722892,0.7710843373,20,320,0.9037900875,0.9208663057,0.1506024096,0.8134110787,332,317,317,332,15,0,0,0,2,1,1,4802,4508,4508,4802,294,1
1237,1382,146,146,0.9913043478,0.9913043478,0,146,0.9966405375,0.9966405375,0.9913043478,0.9966405375,115,115,115,115,0,1,1,2,4,2,2,890,893,890,893,3,1
73,89,17,17,1,1,0,17,1,1,1,1,20,20,20,20,0,0,0,0,4,2,2,158,158,158,158,0,1
207,233,27,48,0.9523809524,1,21,37.5,0.9898989899,1,1,1,21,21,21,21,0,0,0,0,0,0,0,99,99,99,99,0,0
565,575,11,11,0.8461538462,0.9230769231,0,11,0.9797979798,0.9898989899,0.9230769231,0.9898989899,13,13,13,13,0,0,0,0,2,1,1,99,99,99,99,0,1
44,51,8,8,1,1,0,8,1,1,1,1,8,8,8,8,0,4,4,8,2,1,1,116,116,116,116,0,1
617,636,20,20,0.9523809524,0.9523809524,0,20,0.9912280702,0.9912280702,0.9523809524,0.9912280702,21,21,21,21,0,0,0,0,2,1,1,114,114,114,114,0,1
442,454,13,13,1,1,0,13,1,1,1,1,13,13,13,13,0,0,0,0,2,1,1,133,133,133,133,0,1
183,197,15,15,1,1,0,15,1,1,1,1,16,16,16,16,0,0,0,0,2,1,1,119,119,119,119,0,1
505,515,9,11,0.6153846154,0.7692307692,2,10,0.7171717172,0.7474747475,0.3846153846,0.5757575758,11,13,11,13,2,0,0,0,2,1,1,75,99,75,99,24,0
7,18,12,12,1,1,0,12,1,1,1,1,14,14,14,14,0,0,0,0,2,1,1,133,133,133,133,0,1
652,662,10,11,0.6923076923,0.7692307692,1,10.5,0.7878787879,0.8282828283,0.2307692308,0.6262626263,12,13,12,13,1,0,0,0,2,1,1,82,99,82,99,17,0
806,823,17,18,0.6666666667,0.7777777778,1,17.5,0.8604651163,0.9147286822,0.2777777778,0.7286821705,17,18,17,18,1,0,0,0,2,1,1,126,129,126,129,3,1
747,764,17,18,0.7777777778,0.9444444444,1,17.5,0.8992248062,0.9224806202,0.3888888889,0.7441860465,17,18,17,18,1,0,0,0,2,1,1,119,129,119,129,10,1
277,288,12,13,0.5384615385,0.9230769231,1,12.5,0.8347107438,0.9256198347,0.3846153846,0.7685950413,13,12,12,13,1,0,0,0,2,1,1,121,112,112,121,9,1
398,417,20,20,0.2380952381,0.2380952381,0,20,0.3513513514,0.5945945946,0.2380952381,0.3918918919,20,21,20,21,1,0,0,0,2,1,1,144,148,144,148,4,0
44,50,7,7,0.2857142857,0.7142857143,0,7,0.6285714286,0.8857142857,0.2857142857,0.7142857143,7,7,7,7,0,0,0,0,2,1,1,32,35,32,35,3,0
6,11,6,6,1,1,0,6,1,1,1,1,7,7,7,7,0,0,0,0,2,1,1,83,83,83,83,0,1
244,250,6,7,0.4285714286,0.7142857143,1,6.5,0.6923076923,0.9230769231,0.5714285714,0.7692307692,6,7,6,7,1,0,0,0,3,1,2,26,26,26,26,0,0
20,52,33,33,0.9090909091,1,0,33,0.987654321,1,1,1,33,33,33,33,0,0,0,0,2,1,1,243,243,243,243,0,1
126,138,13,13,1,1,0,13,1,1,1,1,13,13,13,13,0,0,0,0,2,1,1,111,111,111,111,0,1
427,438,12,12,0.5833333333,1,0,12,0.8474576271,1,1,1,12,12,12,12,0,0,0,0,2,1,1,59,59,59,59,0,1
127,141,15,29,0.1379310345,0.1724137931,14,22,0.3267973856,0.5163398693,0.1379310345,0.3594771242,29,16,16,29,13,0,0,0,2,1,1,153,112,112,153,41,0
4,11,8,8,0.5,1,0,8,0.8928571429,1,1,1,8,8,8,8,0,0,0,0,0,0,0,56,56,56,56,0,0
633,648,16,16,0.875,0.875,0,16,0.7959183673,0.8163265306,0.5,0.6428571429,16,16,16,16,0,1,1,2,4,2,2,85,98,85,98,13,1
126,141,14,16,0.875,0.875,2,15,0.8504672897,0.8504672897,0.625,0.8130841121,14,16,14,16,2,0,0,0,2,1,1,91,107,91,107,16,0
180,194,13,15,0.4666666667,0.7333333333,2,14,0.6931216931,0.7566137566,0.4,0.6613756614,13,15,13,15,2,0,0,0,2,1,1,144,189,144,189,45,1
222,232,11,11,0.5454545455,1,0,11,0.9295774648,1,1,1,11,11,11,11,0,0,0,0,2,1,1,71,71,71,71,0,0
140,159,20,20,1,1,0,20,1,1,1,1,19,19,19,19,0,1,1,2,4,2,2,192,192,192,192,0,1
119,144,25,26,0.8,0.8666666667,1,25.5,0.9558823529,0.9705882353,0.2,0.6838235294,15,15,15,15,0,0,0,0,4,2,2,135,136,135,136,1,1
73,82,8,10,0.6,0.7,2,9,0.9032258065,0.9193548387,0.7,0.9193548387,9,10,9,10,1,0,0,0,2,1,1,62,62,62,62,0,0
748,767,20,20,0.9523809524,0.9523809524,0,20,0.9912280702,0.9912280702,0.9523809524,0.9912280702,21,21,21,21,0,0,0,0,2,1,1,114,114,114,114,0,1
280,292,13,13,0.6153846154,0.8461538462,0,13,0.77,0.86,0.6923076923,0.79,13,13,13,13,0,1,2,3,2,1,1,100,86,86,100,14,1
984,1025,42,42,0,1,0,42,0.5714285714,1,1,1,42,42,42,42,0,0,0,0,2,1,1,294,294,294,294,0,0
5,20,13,16,0,0.2,3,14.5,0.4931506849,0.8356164384,0,0.698630137,8,10,8,10,2,1,1,2,0,0,0,70,73,70,73,3,0
43,52,10,10,1,1,0,10,1,1,1,1,10,10,10,10,0,0,0,0,2,1,1,88,88,88,88,0,1
1371,1378,8,8,0.625,0.875,0,8,0.8541666667,0.9166666667,0.875,0.9166666667,8,8,8,8,0,0,0,0,2,1,1,46,48,46,48,2,0
776,787,12,15,0.4666666667,0.7333333333,3,13.5,0.6258064516,0.6967741935,0.2666666667,0.5870967742,15,12,12,15,3,0,0,0,2,1,1,155,108,108,155,47,1
1196,1210,15,15,1,1,0,15,1,1,1,1,15,15,15,15,0,0,0,0,2,1,1,113,113,113,113,0,1
1109,1141,30,33,1,1,3,31.5,1,1,1,1,17,17,17,17,0,1,1,2,4,2,2,103,103,103,103,0,0
67,82,16,22,0.1363636364,0.2272727273,6,19,0.2971428571,0.5142857143,0.1363636364,0.3257142857,22,16,16,22,6,0,0,0,2,1,1,175,136,136,175,39,0
128,133,6,6,0,0,0,6,0.5,0.75,0,0.5416666667,6,6,6,6,0,0,0,0,2,1,1,24,24,24,24,0,0
325,346,22,22,1,1,0,22,1,1,1,1,22,22,22,22,0,0,0,0,2,1,1,154,154,154,154,0,0
289,305,17,17,0.5263157895,0.9473684211,0,17,0.8736263736,0.956043956,0.9473684211,0.9505494505,19,19,19,19,0,0,1,1,2,1,1,176,182,176,182,6,1
657,670,14,14,0.8333333333,1,0,14,0.9837837838,1,1,1,18,18,18,18,0,0,0,0,2,1,1,185,185,185,185,0,1
417,720,304,304,1,1,0,304,1,1,1,1,288,288,288,288,0,2,2,4,2,1,1,2224,2224,2224,2224,0,1
1055,1184,130,130,1,1,0,130,1,1,1,1,130,130,130,130,0,1,1,2,2,1,1,755,755,755,755,0,1
27,46,20,20,1,1,0,20,1,1,1,1,20,20,20,20,0,0,0,0,2,1,1,261,261,261,261,0,1
309,347,39,39,0.8974358974,0.8974358974,0,39,0.9506578947,0.9506578947,0.4615384615,0.7105263158,39,39,39,39,0,0,0,0,2,1,1,297,304,297,304,7,1
378,403,26,26,1,1,0,26,1,1,1,1,26,26,26,26,0,0,0,0,2,1,1,182,182,182,182,0,0
29,42,14,14,0.9285714286,0.9285714286,0,14,0.9708029197,0.9708029197,0.9285714286,0.9708029197,14,14,14,14,0,0,0,0,2,1,1,133,137,133,137,4,1
477,507,31,31,0,0,0,31,0.4285714286,0.5714285714,0,0.4377880184,31,31,31,31,0,0,0,0,2,1,1,155,217,155,217,62,0
156,170,15,15,0.7058823529,0.9411764706,0,15,0.9108280255,0.949044586,0.2352941176,0.6687898089,17,17,17,17,0,0,0,0,2,1,1,149,157,149,157,8,1
884,896,13,13,0.3,1,0,13,0.9,1,1,1,10,10,10,10,0,1,1,2,4,2,2,70,70,70,70,0,1
633,649,17,17,1,1,0,17,1,1,1,1,17,17,17,17,0,0,0,0,2,1,1,100,100,100,100,0,1
224,228,5,5,1,1,0,5,1,1,1,1,5,5,5,5,0,0,0,0,2,1,1,52,52,52,52,0,1
133,140,8,8,1,1,0,8,1,1,1,1,10,10,10,10,0,0,0,0,2,1,1,131,131,131,131,0,1
513,518,6,7,0,0.1428571429,1,6.5,0.4235294118,0.6823529412,0,0.5176470588,7,6,6,7,1,0,0,0,2,1,1,80,85,80,85,5,0
735,743,9,11,0.2307692308,0.7692307692,2,10,0.5256410256,0.7307692308,0.3076923077,0.5512820513,13,11,11,13,2,0,0,0,2,1,1,78,57,57,78,21,0
615,639,25,25,0.36,0.6,0,25,0.7702702703,0.8108108108,0.24,0.5945945946,25,22,22,25,3,1,0,1,2,1,1,148,123,123,148,25,0
191,197,7,7,0.4285714286,0.7142857143,0,7,0.59375,0.6875,0.7142857143,0.6875,7,7,7,7,0,0,0,0,2,1,1,23,32,23,32,9,0
18,35,18,19,0,0,1,18.5,0.3939393939,0.6363636364,0,0.4242424242,11,10,10,11,1,1,1,2,1,1,0,66,64,64,66,2,0
76,78,3,3,0,0.6666666667,0,3,0.75,0.9230769231,0.6666666667,0.9038461538,3,3,3,3,0,0,0,0,2,1,1,52,48,48,52,4,0
739,749,11,11,1,1,0,11,1,1,1,1,12,12,12,12,0,5,5,10,2,1,1,111,111,111,111,0,0
34,36,3,3,0,1,0,3,0.8846153846,1,1,1,3,3,3,3,0,0,0,0,2,1,1,52,52,52,52,0,1
31,36,5,6,0.1666666667,0.1666666667,1,5.5,0.3538461538,0.6461538462,0.1666666667,0.4461538462,5,6,5,6,1,1,0,1,2,1,1,60,65,60,65,5,0
613,651,39,39,0.3243243243,1,0,39,0.8797953964,1,1,1,37,37,37,37,0,1,1,2,4,2,2,391,391,391,391,0,0
31,40,10,11,0.4285714286,0.5,1,10.5,0.6564885496,0.6870229008,0.4285714286,0.6641221374,14,14,14,14,0,0,0,0,2,1,1,118,131,118,131,13,1
82,114,14,33,0.0909090909,0.0909090909,19,23.5,0.2739130435,0.4782608696,0.0909090909,0.3434782609,14,33,14,33,19,0,0,0,2,1,1,153,230,153,230,77,0
43,52,10,10,1,1,0,10,1,1,1,1,10,10,10,10,0,0,0,0,2,1,1,88,88,88,88,0,1
390,406,17,17,1,1,0,17,1,1,1,1,17,17,17,17,0,0,0,0,2,1,1,119,119,119,119,0,0
100,109,10,10,0.9,0.9,0,10,0.9848484848,0.9848484848,0.9,0.9848484848,10,10,10,10,0,1,1,2,2,1,1,66,66,66,66,0,1
95,101,7,7,0.875,1,0,7,0.9852941176,1,1,1,8,8,8,8,0,1,1,2,2,1,1,68,68,68,68,0,1
929,937,9,9,0.8888888889,1,0,9,0.9910714286,1,1,1,9,9,9,9,0,1,1,2,2,1,1,112,112,112,112,0,0
165,175,11,11,0.4545454545,0.9090909091,0,11,0.8815789474,0.9736842105,0.9090909091,0.9736842105,11,11,11,11,0,0,0,0,2,1,1,76,76,76,76,0,1
359,369,11,11,1,1,0,11,1,1,1,1,11,11,11,11,0,0,0,0,2,1,1,61,61,61,61,0,1
146,152,7,7,1,1,0,7,1,1,1,1,7,7,7,7,0,0,0,0,2,1,1,92,92,92,92,0,1
392,414,22,23,0.652173913,0.8695652174,1,22.5,0.8634146341,0.9073170732,0.3043478261,0.6975609756,22,23,22,23,1,0,0,0,2,1,1,202,205,202,205,3,0
611,620,10,10,0.5,1,0,10,0.9230769231,1,1,1,10,10,10,10,0,0,0,0,2,1,1,65,65,65,65,0,1
440,452,13,13,1,1,0,13,1,1,1,1,13,13,13,13,0,0,0,0,2,1,1,133,133,133,133,0,1
246,253,8,8,0.75,1,0,8,0.9583333333,1,1,1,8,8,8,8,0,2,2,4,2,1,1,48,48,48,48,0,1
413,422,9,10,0.5833333333,0.75,1,9.5,0.7317073171,0.8048780488,0.25,0.6097560976,11,12,11,12,1,0,0,0,2,1,1,78,82,78,82,4,1
98,103,6,6,0.7142857143,0.8571428571,0,6,0.8405797101,0.884057971,0.2857142857,0.6231884058,7,7,7,7,0,1,1,2,2,1,1,61,69,61,69,8,1
150,163,13,14,0.2142857143,0.7142857143,1,13.5,0.5967741935,0.7419354839,0.6428571429,0.7258064516,13,14,13,14,1,0,0,0,2,1,1,62,55,55,62,7,0
82,98,17,21,0.6666666667,0.7142857143,4,19,0.9637681159,0.9710144928,0.7142857143,0.9710144928,21,17,17,21,4,1,1,2,4,2,2,138,134,134,138,4,0
256,270,15,15,0.9333333333,0.9333333333,0,15,0.9752066116,0.9752066116,0.9333333333,0.9752066116,15,15,15,15,0,0,0,0,2,1,1,118,121,118,121,3,1
371,421,51,51,0,0,0,51,0.5714285714,0.8571428571,0,0.6218487395,51,51,51,51,0,0,0,0,2,1,1,357,357,357,357,0,0
1156,1170,15,18,0.5555555556,0.8333333333,3,16.5,0.8108108108,0.8513513514,0.5,0.7702702703,18,15,15,18,3,0,0,0,2,1,1,148,126,126,148,22,1
212,225,14,14,1,1,0,14,1,1,1,1,15,15,15,15,0,0,0,0,2,1,1,123,123,123,123,0,1
443,485,43,43,1,1,0,43,1,1,1,1,46,46,46,46,0,0,0,0,2,1,1,314,314,314,314,0,1
160,164,5,5,1,1,0,5,1,1,1,1,6,6,6,6,0,2,2,4,2,1,1,69,69,69,69,0,1
112,116,5,5,0.6666666667,1,0,5,0.9672131148,1,1,1,6,6,6,6,0,2,2,4,2,1,1,61,61,61,61,0,1
849,865,17,17,0.2941176471,0.6470588235,0,17,0.5161290323,0.7419354839,0.2941176471,0.5913978495,17,17,17,17,0,0,0,0,2,1,1,89,93,89,93,4,0
134,162,29,29,0,1,0,29,0.5714285714,1,1,1,29,29,29,29,0,0,0,0,2,1,1,203,203,203,203,0,0
309,330,22,22,1,1,0,22,1,1,1,1,23,23,23,23,0,0,0,0,2,1,1,176,176,176,176,0,1
182,187,6,6,0.8571428571,1,0,6,0.9830508475,1,1,1,7,7,7,7,0,1,1,2,2,1,1,59,59,59,59,0,1
708,724,17,17,0.8235294118,0.8823529412,0,17,0.9256198347,0.9504132231,0.7058823529,0.8760330579,17,17,17,17,0,0,0,0,2,1,1,121,119,119,121,2,1
135,189,54,55,0.8,0.9090909091,1,54.5,0.905982906,0.9401709402,0.5272727273,0.8091168091,54,55,54,55,1,0,0,0,2,1,1,346,351,346,351,5,1
149,154,6,6,1,1,0,6,1,1,1,1,6,6,6,6,0,1,1,2,2,1,1,54,54,54,54,0,1
667,685,18,19,0.8571428571,0.9047619048,1,18.5,0.8724832215,0.8926174497,0.7142857143,0.8187919463,20,21,20,21,1,0,0,0,2,1,1,137,149,137,149,12,1
51,53,3,3,0,1,0,3,0.8076923077,1,1,1,3,3,3,3,0,0,0,0,2,1,1,52,52,52,52,0,0
419,498,80,80,1,1,0,80,1,1,1,1,80,80,80,80,0,0,0,0,2,1,1,560,560,560,560,0,1
641,649,9,9,0.6363636364,0.7272727273,0,9,0.5568181818,0.6590909091,0.3636363636,0.4886363636,11,11,11,11,0,0,0,0,2,1,1,88,75,75,88,13,1
73,95,23,23,1,1,0,23,1,1,1,1,23,23,23,23,0,0,0,0,2,1,1,164,164,164,164,0,1
550,593,44,44,0.9545454545,1,0,44,0.9935064935,1,0.9545454545,0.9935064935,44,44,44,44,0,0,0,0,2,1,1,308,308,308,308,0,1
198,208,11,11,0.75,0.75,0,11,0.7435897436,0.7820512821,0.3333333333,0.5897435897,12,12,12,12,0,0,0,0,2,1,1,78,75,75,78,3,1
648,665,18,23,0.68,0.72,5,20.5,0.7165775401,0.7326203209,0.32,0.5989304813,25,20,20,25,5,0,0,0,2,1,1,187,137,137,187,50,1
1055,1067,13,13,1,1,0,13,1,1,1,1,13,13,13,13,0,0,0,0,2,1,1,96,96,96,96,0,1
349,379,31,32,0.96875,0.96875,1,31.5,0.9874371859,0.9874371859,0.4375,0.743718593,32,31,31,32,1,0,0,0,2,1,1,398,393,393,398,5,1
546,570,25,25,0.8461538462,1,0,25,0.9759615385,1,1,1,26,26,26,26,0,1,1,2,4,2,2,208,208,208,208,0,1
110,197,88,88,1,1,0,88,1,1,1,1,88,88,88,88,0,0,0,0,2,1,1,484,484,484,484,0,1
140,150,10,11,0.1818181818,0.1818181818,1,10.5,0.4074074074,0.6296296296,0.1818181818,0.4197530864,10,11,10,11,1,0,0,0,2,1,1,81,74,74,81,7,0
172,181,10,10,0.8,0.9,0,10,0.9411764706,0.9803921569,0.9,0.9803921569,10,10,10,10,0,0,0,0,2,1,1,51,51,51,51,0,1
99,111,13,13,1,1,0,13,1,1,1,1,13,13,13,13,0,0,0,0,2,1,1,117,117,117,117,0,1
443,485,43,43,1,1,0,43,1,1,1,1,46,46,46,46,0,0,0,0,2,1,1,314,314,314,314,0,1
209,258,50,50,0.9607843137,0.9607843137,0,50,0.9662650602,0.9734939759,0.1176470588,0.6819277108,51,51,51,51,0,2,2,4,4,2,2,409,415,409,415,6,1
1549,1565,12,17,0.4705882353,0.7058823529,5,14.5,0.7253521127,0.7535211268,0.2941176471,0.661971831,12,17,12,17,5,0,0,0,2,1,1,107,142,107,142,35,1
648,665,18,23,0.68,0.72,5,20.5,0.7165775401,0.7326203209,0.32,0.5989304813,25,20,20,25,5,0,0,0,2,1,1,187,137,137,187,50,1
53,166,114,114,0.9915966387,0.9915966387,0,114,0.9990749306,0.9990749306,0.9915966387,0.9990749306,119,119,119,119,0,0,0,0,2,1,1,1081,1081,1081,1081,0,1
54,108,55,55,1,1,0,55,1,1,1,1,55,55,55,55,0,3,3,6,2,1,1,438,438,438,438,0,1
432,441,10,10,0.5833333333,0.8333333333,0,10,0.8023255814,0.8953488372,0.4166666667,0.8023255814,12,12,12,12,0,0,0,0,2,1,1,86,83,83,86,3,1
216,229,14,14,1,1,0,14,1,1,1,1,14,14,14,14,0,0,0,0,2,1,1,107,107,107,107,0,1
1053,1062,10,10,0.5833333333,0.8333333333,0,10,0.7674418605,0.8953488372,0.5,0.7906976744,12,12,12,12,0,0,0,0,2,1,1,82,86,82,86,4,1
221,231,11,11,0.9090909091,1,0,11,0.9909090909,1,1,1,11,11,11,11,0,1,1,2,2,1,1,110,110,110,110,0,1
10,18,9,9,1,1,0,9,1,1,1,1,11,11,11,11,0,0,0,0,2,1,1,114,114,114,114,0,1
125,157,33,33,1,1,0,33,1,1,1,1,31,31,31,31,0,3,3,6,4,2,2,208,208,208,208,0,1
175,181,7,7,0.1428571429,0.4285714286,0,7,0.511627907,0.6976744186,0.1428571429,0.6279069767,7,7,7,7,0,1,1,2,2,1,1,34,43,34,43,9,0
201,210,10,10,0.3,0.6,0,10,0.5333333333,0.7333333333,0.4,0.5833333333,10,10,10,10,0,0,0,0,2,1,1,49,60,49,60,11,0
137,146,10,10,0.9166666667,1,0,10,0.9936305732,1,0.9166666667,0.9936305732,12,12,12,12,0,0,0,0,2,1,1,157,157,157,157,0,1
264,274,11,12,0.5,0.8333333333,1,11.5,0.7972972973,0.9189189189,0.8333333333,0.8783783784,12,11,11,12,1,0,0,0,2,1,1,74,73,73,74,1,1
112,128,17,17,0.5263157895,0.8421052632,0,17,0.8352272727,0.8977272727,0.4210526316,0.6875,19,19,19,19,0,1,0,1,2,1,1,166,176,166,176,10,1
546,568,18,23,0.68,0.72,5,20.5,0.7165775401,0.7326203209,0.32,0.5989304813,20,25,20,25,5,0,0,0,2,1,1,137,187,137,187,50,1
49,58,10,15,0.0666666667,0.0666666667,5,12.5,0.2682926829,0.3902439024,0.0666666667,0.2845528455,15,10,10,15,5,0,0,0,2,1,1,123,68,68,123,55,0
661,705,45,45,0.3111111111,0.9777777778,0,45,0.79375,0.98125,0.9777777778,0.98125,45,45,45,45,0,0,1,1,2,1,1,160,158,158,160,2,0
129,151,14,23,0.2173913043,0.2608695652,9,18.5,0.2685185185,0.4027777778,0.2173913043,0.2962962963,14,23,14,23,9,0,0,0,2,1,1,112,216,112,216,104,0
210,219,10,10,1,1,0,10,1,1,1,1,10,10,10,10,0,1,1,2,2,1,1,50,50,50,50,0,1
648,665,18,18,1,1,0,18,1,1,1,1,20,20,20,20,0,0,0,0,2,1,1,137,137,137,137,0,1
248,261,13,14,0.4285714286,0.8571428571,1,13.5,0.7482014388,0.8705035971,0.2857142857,0.7050359712,13,14,13,14,1,0,0,0,2,1,1,121,139,121,139,18,1
97,106,10,10,0.5,1,0,10,0.9230769231,1,1,1,10,10,10,10,0,0,0,0,3,2,1,65,65,65,65,0,1
176,192,17,17,0.7368421053,1,0,17,0.9695121951,1,1,1,19,19,19,19,0,1,1,2,2,1,1,164,164,164,164,0,1
595,609,15,15,0.8,0.9333333333,0,15,0.9659863946,0.9795918367,0.9333333333,0.9795918367,15,15,15,15,0,1,0,1,2,1,1,146,147,146,147,1,1
82,106,25,25,0.8214285714,1,0,25,0.979338843,1,1,1,28,28,28,28,0,1,1,2,2,1,1,242,242,242,242,0,1
208,241,34,34,1,1,0,34,1,1,1,1,35,35,35,35,0,0,0,0,2,1,1,387,387,387,387,0,1
61,79,19,19,0.9473684211,0.9473684211,0,19,0.9269662921,0.9325842697,0.9473684211,0.9269662921,19,19,19,19,0,0,0,0,2,1,1,178,166,166,178,12,1
322,352,31,31,1,1,0,31,1,1,1,1,31,31,31,31,0,0,0,0,2,1,1,217,217,217,217,0,1
1006,1019,14,14,1,1,0,14,1,1,1,1,14,14,14,14,0,0,0,0,2,1,1,120,120,120,120,0,1
84,94,11,11,0.7272727273,0.7272727273,0,11,0.9722222222,0.9722222222,0.7272727273,0.9722222222,11,11,11,11,0,0,0,0,2,1,1,105,108,105,108,3,1
247,262,16,18,0.3333333333,0.8888888889,2,17,0.8162162162,0.9243243243,0.6666666667,0.8918918919,18,16,16,18,2,0,0,0,2,1,1,185,171,171,185,14,0
435,444,10,10,0.75,1,0,10,0.9390243902,1,0.75,0.9512195122,12,12,12,12,0,0,0,0,2,1,1,82,82,82,82,0,1
17,45,29,29,0,0,0,29,0.4444444444,0.7777777778,0,0.7777777778,29,29,29,29,0,0,0,0,1,1,0,203,261,203,261,58,0
570,590,21,23,0.84,0.88,2,22,0.8395721925,0.871657754,0.68,0.807486631,25,23,23,25,2,0,0,0,2,1,1,187,166,166,187,21,1
18,31,10,14,0.6,0.6666666667,4,12,0.952,0.968,0.6666666667,0.968,12,15,12,15,3,0,0,0,2,1,1,121,125,121,125,4,1
235,245,11,15,0.1333333333,0.2666666667,4,13,0.304,0.528,0.1333333333,0.352,15,12,12,15,3,0,0,0,2,1,1,125,102,102,125,23,0
455,485,31,31,1,1,0,31,1,1,1,1,31,31,31,31,0,0,0,0,2,1,1,217,217,217,217,0,1
539,545,7,7,0.875,1,0,7,0.9871794872,1,1,1,8,8,8,8,0,3,3,6,2,1,1,78,78,78,78,0,1
448,495,48,48,1,1,0,48,1,1,1,1,48,48,48,48,0,0,0,0,2,1,1,336,336,336,336,0,0
687,703,17,17,1,1,0,17,1,1,1,1,17,17,17,17,0,0,0,0,2,1,1,84,84,84,84,0,1
390,461,72,72,1,1,0,72,1,1,1,1,77,77,77,77,0,0,0,0,2,1,1,850,850,850,850,0,1
82,98,17,17,0.6315789474,0.8947368421,0,17,0.8922155689,0.9401197605,0.7894736842,0.9221556886,19,19,19,19,0,0,1,1,2,1,1,167,165,165,167,2,1
75,91,17,17,1,1,0,17,1,1,1,1,17,17,17,17,0,0,0,0,2,1,1,148,148,148,148,0,1
3,10,8,8,0.5,0.875,0,8,0.8,0.9333333333,0.875,0.9,8,8,8,8,0,0,0,0,0,0,0,60,56,56,60,4,0
304,314,11,11,0.5454545455,1,0,11,0.8769230769,1,1,1,11,11,11,11,0,0,0,0,2,1,1,65,65,65,65,0,1
571,585,15,15,0.8666666667,1,0,15,0.9863945578,1,1,1,15,15,15,15,0,0,0,0,2,1,1,147,147,147,147,0,1
1784,1805,22,22,1,1,0,22,1,1,1,1,22,22,22,22,0,0,0,0,2,1,1,127,127,127,127,0,1
96,100,5,5,1,1,0,5,1,1,1,1,5,5,5,5,0,1,1,2,2,1,1,52,52,52,52,0,1
160,184,25,25,0.6071428571,1,0,25,0.9346153846,1,1,1,28,28,28,28,0,1,1,2,2,1,1,260,260,260,260,0,1
628,638,11,11,0.9166666667,0.9166666667,0,11,0.9857142857,0.9857142857,0.9166666667,0.9857142857,12,12,12,12,0,3,3,6,2,1,1,70,70,70,70,0,1
267,272,6,7,0.1428571429,0.1428571429,1,6.5,0.3552631579,0.6184210526,0.1428571429,0.4210526316,6,7,6,7,1,0,0,0,3,2,1,76,68,68,76,8,0
791,810,20,20,0.6666666667,0.9523809524,0,20,0.9210526316,0.9912280702,0.9523809524,0.9912280702,21,21,21,21,0,0,0,0,2,1,1,114,114,114,114,0,1
381,392,12,12,1,1,0,12,1,1,1,1,14,14,14,14,0,0,0,0,2,1,1,124,124,124,124,0,1
85,85,1,1,0,0,0,1,0.3647192286,0.5967101531,0,0.5967101531,1,1,1,1,0,0,0,0,2,1,1,1763,1053,1053,1763,710,1
243,252,10,10,1,1,0,10,1,1,1,1,10,10,10,10,0,0,0,0,2,1,1,90,90,90,90,0,1
166,222,57,57,1,1,0,57,1,1,1,1,53,53,53,53,0,1,1,2,4,2,2,348,348,348,348,0,0
4,20,17,17,1,1,0,17,1,1,1,1,15,15,15,15,0,0,0,0,0,0,0,143,143,143,143,0,1
10,10,1,1545,0.0357142857,0.0357142857,1544,773,0.9316466933,0.9316466933,0.0357142857,0.9316466933,28,1,1,28,27,1,0,1,0,0,0,2253,2099,2099,2253,154,0
70,86,17,17,0.5263157895,0.8947368421,0,17,0.8516483516,0.9120879121,0.4736842105,0.7142857143,19,19,19,19,0,1,1,2,2,1,1,166,182,166,182,16,0
186,200,15,15,0.8666666667,0.8666666667,0,15,0.9367088608,0.9493670886,0.3333333333,0.6835443038,15,15,15,15,0,0,0,0,2,1,1,76,79,76,79,3,1
454,470,17,20,0.45,0.85,3,18.5,0.7660550459,0.8073394495,0.8,0.8027522936,20,17,17,20,3,0,0,0,2,1,1,218,176,176,218,42,1
77,101,25,25,1,1,0,25,1,1,1,1,25,25,25,25,0,0,0,0,2,1,1,172,172,172,172,0,1
445,475,31,31,1,1,0,31,1,1,1,1,31,31,31,31,0,0,0,0,2,1,1,217,217,217,217,0,1
974,991,18,18,0.3333333333,1,0,18,0.9243243243,1,1,1,18,18,18,18,0,0,0,0,2,1,1,185,185,185,185,0,1
541,674,134,134,0.3307086614,0.9448818898,0,134,0.76443769,0.9680851064,0.3385826772,0.8092705167,127,127,127,127,0,1,1,2,4,2,2,1316,1274,1274,1316,42,1
505,536,32,32,0,0,0,32,0.4444444444,0.7777777778,0,0.7777777778,32,32,32,32,0,0,0,0,2,1,1,224,288,224,288,64,0
432,442,11,11,0.6153846154,0.7692307692,0,11,0.8461538462,0.9615384615,0.6923076923,0.9358974359,13,13,13,13,0,0,0,0,2,1,1,78,78,78,78,0,1
550,578,28,29,0.7,0.8333333333,1,28.5,0.8436363636,0.8945454545,0.3666666667,0.6763636364,29,30,29,30,1,0,0,0,2,1,1,275,263,263,275,12,1
24,69,46,46,1,1,0,46,1,1,1,1,40,40,40,40,0,0,0,0,0,0,0,276,276,276,276,0,1
811,836,26,26,0.9615384615,0.9615384615,0,26,0.9014778325,0.9014778325,0.7307692308,0.8620689655,26,26,26,26,0,0,0,0,2,1,1,203,183,183,203,20,1
74,94,21,21,1,1,0,21,1,1,1,1,20,20,20,20,0,0,0,0,4,2,2,134,134,134,134,0,0
12,36,25,25,1,1,0,25,1,1,1,1,25,25,25,25,0,2,2,4,2,1,1,227,227,227,227,0,1
127,138,12,12,0.9166666667,1,0,12,0.9913793103,1,1,1,12,12,12,12,0,0,0,0,2,1,1,116,116,116,116,0,1
94,100,7,7,0,0.2857142857,0,7,0.4098360656,0.6229508197,0,0.5081967213,7,7,7,7,0,0,0,0,2,1,1,57,61,57,61,4,0
167,169,3,3,1,1,0,3,1,1,1,1,4,4,4,4,0,1,1,2,2,1,1,81,81,81,81,0,1
192,201,10,10,0.4,0.5,0,10,0.5306122449,0.7142857143,0.4,0.6734693878,10,10,10,10,0,0,0,0,3,2,1,49,45,45,49,4,0
66,68,3,3,0,1,0,3,0.8928571429,1,1,1,3,3,3,3,0,0,0,0,2,1,1,56,56,56,56,0,0
10,10,1,215,0.0357142857,0.0357142857,214,108,0.9316466933,0.9316466933,0.0357142857,0.9316466933,28,1,1,28,27,1,0,1,0,0,0,2253,2099,2099,2253,154,0
443,483,41,41,1,1,0,41,1,1,1,1,41,41,41,41,0,0,0,0,2,1,1,287,287,287,287,0,1
769,777,9,9,0.4444444444,1,0,9,0.8305084746,1,1,1,9,9,9,9,0,1,1,2,2,1,1,59,59,59,59,0,1
1098,1112,12,15,0.5333333333,0.8,3,13.5,0.7338129496,0.7697841727,0.3333333333,0.6690647482,12,15,12,15,3,0,0,0,2,1,1,107,139,107,139,32,1
167,173,7,7,0.625,0.875,0,7,0.8421052632,0.8947368421,0.375,0.6578947368,8,8,8,8,0,1,1,2,2,1,1,68,76,68,76,8,1
257,265,7,9,0.3333333333,0.6666666667,2,8,0.9178082192,0.9726027397,0.6666666667,0.9726027397,7,9,7,9,2,0,0,0,2,1,1,71,73,71,73,2,1
297,306,10,10,1,1,0,10,1,1,1,1,10,10,10,10,0,0,0,0,2,1,1,77,77,77,77,0,1
47,58,12,17,0.1176470588,0.2352941176,5,14.5,0.3333333333,0.5402298851,0.1176470588,0.3850574713,17,12,12,17,5,0,0,0,2,1,1,174,122,122,174,52,1
353,379,27,27,1,1,0,27,1,1,1,1,27,27,27,27,0,1,1,2,2,1,1,351,351,351,351,0,1
172,362,180,191,0.942408377,0.942408377,11,185.5,0.9547244094,0.9547244094,0.0680628272,0.6023622047,180,191,180,191,11,0,0,0,3,2,1,1455,1524,1455,1524,69,1
164,175,12,12,0.5833333333,0.9166666667,0,12,0.880952381,0.9444444444,0.5,0.8333333333,12,12,12,12,0,0,0,0,2,1,1,126,120,120,126,6,1
837,855,19,19,1,1,0,19,1,1,1,1,19,19,19,19,0,3,3,6,2,1,1,171,171,171,171,0,1
947,956,10,10,1,1,0,10,1,1,1,1,10,10,10,10,0,0,0,0,2,1,1,50,50,50,50,0,1
433,444,11,12,0.1428571429,0.1428571429,1,11.5,0.320754717,0.5031446541,0.1428571429,0.3836477987,11,14,11,14,3,0,0,0,2,1,1,113,159,113,159,46,1
369,379,11,12,0.75,0.9166666667,1,11.5,0.8728813559,0.8898305085,0.9166666667,0.8898305085,12,11,11,12,1,0,0,0,2,1,1,118,105,105,118,13,1
546,570,25,25,0.8461538462,1,0,25,0.9759615385,1,1,1,26,26,26,26,0,1,1,2,4,2,2,208,208,208,208,0,1
656,681,26,26,1,1,0,26,1,1,1,1,26,26,26,26,0,0,0,0,2,1,1,124,124,124,124,0,1
74,87,14,14,1,1,0,14,1,1,1,1,14,14,14,14,0,0,0,0,2,1,1,127,127,127,127,0,1
247,269,13,23,0.1304347826,0.1739130435,10,18,0.2532467532,0.4220779221,0.1304347826,0.2727272727,13,23,13,23,10,0,0,0,2,1,1,84,154,84,154,70,0
1128,1141,12,14,0.5714285714,0.7857142857,2,13,0.8017241379,0.8620689655,0.7142857143,0.8275862069,12,14,12,14,2,0,0,0,2,1,1,101,116,101,116,15,1
470,476,7,7,0.7142857143,0.7142857143,0,7,0.7571428571,0.8285714286,0.7142857143,0.8285714286,7,7,7,7,0,1,0,1,2,1,1,70,61,61,70,9,1
388,409,22,22,0,0,0,22,0.4444444444,0.6666666667,0,0.5606060606,22,22,22,22,0,0,0,0,2,1,1,198,154,154,198,44,0
469,509,41,41,1,1,0,41,1,1,1,1,41,41,41,41,0,0,0,0,2,1,1,287,287,287,287,0,1
166,174,9,13,0.1666666667,0.25,4,11,0.3580246914,0.5555555556,0.25,0.4567901235,12,9,9,12,3,1,1,2,3,2,1,81,61,61,81,20,0
1343,1356,14,14,0.7857142857,1,0,14,0.9666666667,1,1,1,14,14,14,14,0,0,0,0,2,1,1,120,120,120,120,0,1
400,405,6,6,0.1666666667,0.8333333333,0,6,0.5833333333,0.9722222222,0.1666666667,0.7222222222,6,6,6,6,0,0,0,0,2,1,1,36,36,36,36,0,0
250,259,9,10,0.2222222222,0.2222222222,1,9.5,0.2297297297,0.4459459459,0.2222222222,0.3378378378,9,9,9,9,0,3,0,3,3,1,2,55,74,55,74,19,0
574,584,11,13,0.6,0.6,2,12,0.7777777778,0.8080808081,0.2,0.6060606061,15,13,13,15,2,0,0,0,2,1,1,97,99,97,99,2,1
231,242,12,12,1,1,0,12,1,1,1,1,13,13,13,13,0,1,1,2,2,1,1,108,108,108,108,0,1
10,21,12,12,0.9285714286,0.9285714286,0,12,0.992481203,0.992481203,0.9285714286,0.992481203,14,14,14,14,0,0,0,0,2,1,1,132,133,132,133,1,1
232,245,14,14,1,1,0,14,1,1,1,1,14,14,14,14,0,0,0,0,2,1,1,107,107,107,107,0,1
428,453,26,26,1,1,0,26,1,1,1,1,26,26,26,26,0,0,0,0,2,1,1,182,182,182,182,0,1
159,165,7,7,0.1428571429,0.7142857143,0,7,0.7543859649,0.8771929825,0.7142857143,0.8771929825,7,7,7,7,0,1,0,1,2,1,1,52,57,52,57,5,0
336,342,7,8,0.375,0.75,1,7.5,0.6285714286,0.7714285714,0.375,0.6571428571,8,7,7,8,1,0,0,0,2,1,1,35,28,28,35,7,0
275,300,26,26,1,1,0,26,1,1,1,1,26,26,26,26,0,2,2,4,2,1,1,159,159,159,159,0,1
570,590,21,21,1,1,0,21,1,1,1,1,23,23,23,23,0,0,0,0,2,1,1,166,166,166,166,0,1
187,195,9,9,0.5555555556,1,0,9,0.9637681159,1,1,1,9,9,9,9,0,0,0,0,2,1,1,138,138,138,138,0,1
858,875,18,18,1,1,0,18,1,1,1,1,18,18,18,18,0,1,1,2,2,1,1,211,211,211,211,0,1
301,317,17,17,0.8823529412,0.9411764706,0,17,0.9494949495,0.9696969697,0.5294117647,0.7575757576,17,17,17,17,0,0,0,0,2,1,1,99,97,97,99,2,1
1041,1055,15,17,0.4705882353,0.7647058824,2,16,0.8309859155,0.8943661972,0.2941176471,0.7676056338,17,15,15,17,2,0,0,0,2,1,1,142,131,131,142,11,1
102,121,20,20,0.7619047619,0.9523809524,0,20,0.8854961832,0.9389312977,0.6666666667,0.893129771,21,21,21,21,0,0,0,0,2,1,1,131,131,131,131,0,1
448,458,11,11,1,1,0,11,1,1,1,1,13,13,13,13,0,0,0,0,2,1,1,95,95,95,95,0,1
635,675,41,41,1,1,0,41,1,1,1,1,44,44,44,44,0,0,0,0,2,1,1,315,315,315,315,0,1
648,665,18,18,1,1,0,18,1,1,1,1,20,20,20,20,0,0,0,0,2,1,1,137,137,137,137,0,1
983,1023,41,41,1,1,0,41,1,1,1,1,42,42,42,42,0,4,4,8,2,1,1,284,284,284,284,0,1
669,676,8,9,0.6363636364,0.7272727273,1,8.5,0.6923076923,0.7307692308,0.3636363636,0.6025641026,11,10,10,11,1,0,0,0,2,1,1,78,62,62,78,16,0
1144,1160,17,18,0.7777777778,0.8333333333,1,17.5,0.6629213483,0.7078651685,0.5,0.6235955056,18,17,17,18,1,0,0,0,2,1,1,129,178,129,178,49,1
26,62,37,42,0.6904761905,0.7619047619,5,39.5,0.8244514107,0.8463949843,0.2380952381,0.6018808777,42,37,37,42,5,0,0,0,2,1,1,319,284,284,319,35,1
24,42,19,19,1,1,0,19,1,1,1,1,19,19,19,19,0,0,0,0,2,1,1,126,126,126,126,0,1
369,463,95,95,1,1,0,95,1,1,1,1,32,32,32,32,0,2,2,4,4,2,2,277,277,277,277,0,1
126,133,8,8,0.625,1,0,8,0.9436619718,1,1,1,8,8,8,8,0,0,0,0,2,1,1,71,71,71,71,0,0
73,139,67,67,1,1,0,67,1,1,1,1,66,66,66,66,0,1,1,2,4,2,2,558,558,558,558,0,1
204,220,17,17,0.7058823529,0.8235294118,0,17,0.8634361233,0.9118942731,0.6470588235,0.8634361233,17,17,17,17,0,0,0,0,2,1,1,227,220,220,227,7,1
434,481,48,48,1,1,0,48,1,1,1,1,48,48,48,48,0,0,0,0,2,1,1,336,336,336,336,0,1
278,291,14,14,0.625,0.625,0,14,0.8524590164,0.9098360656,0.3125,0.6967213115,16,16,16,16,0,0,0,0,2,1,1,122,122,122,122,0,1
425,436,12,15,0.4,0.8,3,13.5,0.6862745098,0.7320261438,0.4666666667,0.7124183007,15,12,12,15,3,0,0,0,2,1,1,153,112,112,153,41,1
73,82,10,10,1,1,0,10,1,1,1,1,10,10,10,10,0,0,0,0,2,1,1,62,62,62,62,0,1
1295,1311,17,17,1,1,0,17,1,1,1,1,18,18,18,18,0,1,1,2,2,1,1,192,192,192,192,0,1
61,74,14,15,0.0666666667,0.8,1,14.5,0.5473684211,0.9263157895,0.0666666667,0.6631578947,15,14,14,15,1,0,0,0,2,1,1,95,89,89,95,6,1
163,172,10,10,0.2,0.7,0,10,0.4736842105,0.6842105263,0.5,0.5964912281,10,10,10,10,0,0,0,0,2,1,1,57,46,46,57,11,0
1286,1322,37,37,1,1,0,37,1,1,1,1,40,40,40,40,0,0,0,0,2,1,1,332,332,332,332,0,1
1,274,274,274,1,1,0,274,1,1,1,1,237,237,237,237,0,0,0,0,0,0,0,1967,1967,1967,1967,0,1
189,209,21,21,0.9545454545,0.9545454545,0,21,0.9714285714,0.9714285714,0.4545454545,0.7642857143,22,22,22,22,0,3,3,6,2,1,1,140,136,136,140,4,0
397,414,18,18,0.3529411765,1,0,18,0.875,1,1,1,17,17,17,17,0,1,1,2,4,2,2,192,192,192,192,0,1
248,261,13,14,0.4285714286,0.8571428571,1,13.5,0.7482014388,0.8705035971,0.2857142857,0.7050359712,13,14,13,14,1,0,0,0,2,1,1,121,139,121,139,18,1
17,51,35,35,0.8285714286,1,0,35,0.92,1,1,1,35,35,35,35,0,0,0,0,2,1,1,225,225,225,225,0,1
1237,1271,35,35,1,1,0,35,1,1,1,1,36,36,36,36,0,0,0,0,2,1,1,261,261,261,261,0,1
35,50,16,16,1,1,0,16,1,1,1,1,17,17,17,17,0,0,0,0,2,1,1,135,135,135,135,0,1
335,349,15,15,1,1,0,15,1,1,1,1,15,15,15,15,0,0,0,0,2,1,1,117,117,117,117,0,1
8,29,22,24,0.6538461538,0.8461538462,2,23,0.7957446809,0.8510638298,0.6923076923,0.8,26,23,23,26,3,0,0,0,2,1,1,235,200,200,235,35,1
84,97,14,14,1,1,0,14,1,1,1,1,14,14,14,14,0,0,0,0,2,1,1,73,73,73,73,0,1
335,349,15,15,1,1,0,15,1,1,1,1,15,15,15,15,0,0,0,0,2,1,1,117,117,117,117,0,1
280,289,10,10,1,1,0,10,1,1,1,1,11,11,11,11,0,0,0,0,2,1,1,131,131,131,131,0,1
78,99,22,25,0.12,0.2,3,23.5,0.4047619048,0.6488095238,0.12,0.4761904762,25,22,22,25,3,0,0,0,2,1,1,165,168,165,168,3,0
396,443,48,48,1,1,0,48,1,1,1,1,48,48,48,48,0,0,0,0,2,1,1,336,336,336,336,0,1
10,31,1,22,0.0555555556,0.0555555556,21,11.5,0.9527916478,0.9527916478,0.0555555556,0.9527916478,1,18,1,18,17,0,1,1,1,0,1,2099,2203,2099,2203,104,0
728,740,13,13,0.1578947368,0.3157894737,0,13,0.5338983051,0.593220339,0.1578947368,0.4322033898,19,10,10,19,9,1,1,2,4,2,2,118,70,70,118,48,1
354,383,30,30,1,1,0,30,1,1,1,1,30,30,30,30,0,0,0,0,2,1,1,210,210,210,210,0,0
27,38,12,20,0.15,0.2,8,16,0.3247863248,0.5555555556,0.15,0.452991453,20,12,12,20,8,0,0,0,2,1,1,117,87,87,117,30,0
312,325,11,14,0.2142857143,0.2857142857,3,12.5,0.3009708738,0.4563106796,0.2142857143,0.359223301,11,14,11,14,3,0,0,0,2,1,1,58,103,58,103,45,0
871,897,27,27,1,1,0,27,1,1,1,1,27,27,27,27,0,0,0,0,2,1,1,193,193,193,193,0,1
617,626,10,10,0.5833333333,0.8333333333,0,10,0.7888888889,0.8555555556,0.4166666667,0.7777777778,12,12,12,12,0,0,0,0,2,1,1,90,83,83,90,7,1
246,256,11,14,0.2857142857,0.2857142857,3,12.5,0.4492753623,0.6231884058,0.2857142857,0.5072463768,14,11,11,14,3,0,0,0,2,1,1,69,59,59,69,10,0
440,463,24,24,0,0,0,24,0.4444444444,0.6666666667,0,0.6666666667,24,24,24,24,0,0,0,0,1,0,1,216,168,168,216,48,0
54,60,7,7,0.1428571429,0.7142857143,0,7,0.4901960784,0.862745098,0.1428571429,0.6666666667,7,7,7,7,0,0,0,0,2,1,1,50,51,50,51,1,0
359,369,11,14,0.2857142857,0.2857142857,3,12.5,0.375,0.5208333333,0.2857142857,0.4270833333,14,11,11,14,3,0,0,0,2,1,1,96,61,61,96,35,0
573,587,15,15,1,1,0,15,1,1,1,1,15,15,15,15,0,0,0,0,2,1,1,147,147,147,147,0,1
443,485,43,43,1,1,0,43,1,1,1,1,46,46,46,46,0,0,0,0,2,1,1,314,314,314,314,0,1
964,975,12,12,1,1,0,12,1,1,1,1,12,12,12,12,0,0,0,0,2,1,1,101,101,101,101,0,1
40,73,34,34,1,1,0,34,1,1,1,1,34,34,34,34,0,1,1,2,2,1,1,266,266,266,266,0,0
523,542,20,20,0.6666666667,0.9523809524,0,20,0.9210526316,0.9912280702,0.9523809524,0.9912280702,21,21,21,21,0,0,0,0,2,1,1,114,114,114,114,0,1
422,436,15,17,0.3529411765,0.8235294118,2,16,0.7558139535,0.9186046512,0.4117647059,0.7965116279,17,15,15,17,2,0,0,0,2,1,1,172,164,164,172,8,1
39,47,9,9,0.8888888889,0.8888888889,0,9,0.9032258065,0.935483871,0.3333333333,0.7258064516,9,9,9,9,0,1,1,2,2,1,1,62,58,58,62,4,1
579,584,6,6,1,1,0,6,1,1,1,1,6,6,6,6,0,0,0,0,2,1,1,58,58,58,58,0,1
477,485,9,9,0.6363636364,0.7272727273,0,9,0.6666666667,0.7466666667,0.4545454545,0.56,11,11,11,11,0,0,0,0,2,1,1,75,64,64,75,11,1
164,194,31,31,1,1,0,31,1,1,1,1,31,31,31,31,0,3,3,6,4,2,2,224,224,224,224,0,1
73,82,8,10,0.6,0.7,2,9,0.9032258065,0.9193548387,0.7,0.9193548387,9,10,9,10,1,0,0,0,2,1,1,62,62,62,62,0,1
111,129,19,19,0.3157894737,0.9473684211,0,19,0.8638743455,0.9267015707,0.9473684211,0.9267015707,19,19,19,19,0,0,0,0,2,1,1,191,177,177,191,14,0
522,540,19,19,1,1,0,19,1,1,1,1,20,20,20,20,0,0,0,0,2,1,1,235,235,235,235,0,1
43,83,41,65,0.5384615385,0.5384615385,24,53,0.9496981891,0.9496981891,0.5384615385,0.9496981891,65,51,51,65,14,2,1,3,2,1,1,497,493,493,497,4,1
118,141,24,24,1,1,0,24,1,1,1,1,23,23,23,23,0,3,3,6,2,1,1,137,137,137,137,0,1
490,506,17,17,1,1,0,17,1,1,1,1,17,17,17,17,0,0,0,0,2,1,1,119,119,119,119,0,1
370,382,13,13,1,1,0,13,1,1,1,1,13,13,13,13,0,0,0,0,2,1,1,94,94,94,94,0,1
235,257,23,23,0.8,0.8,0,23,0.929245283,0.929245283,0.36,0.6698113208,25,25,25,25,0,0,0,0,2,1,1,212,202,202,212,10,1
60,65,6,7,0,0,1,6.5,0.4,0.6909090909,0,0.4909090909,7,6,6,7,1,0,1,1,2,1,1,55,55,55,55,0,0
557,584,28,29,0.935483871,0.935483871,1,28.5,0.9464285714,0.9464285714,0.8064516129,0.880952381,31,30,30,31,1,0,0,0,2,1,1,336,320,320,336,16,1
335,349,15,15,1,1,0,15,1,1,1,1,15,15,15,15,0,0,0,0,2,1,1,117,117,117,117,0,1
643,660,18,23,0.68,0.72,5,20.5,0.7165775401,0.7326203209,0.32,0.5989304813,25,20,20,25,5,0,0,0,2,1,1,187,137,137,187,50,1
9,159,151,151,1,1,0,151,1,1,1,1,147,147,147,147,0,0,0,0,0,0,0,902,902,902,902,0,1
570,590,21,23,0.84,0.88,2,22,0.8395721925,0.871657754,0.68,0.807486631,25,23,23,25,2,0,0,0,2,1,1,187,166,166,187,21,1
97,100,4,4,0.75,1,0,4,0.9710144928,1,1,1,4,4,4,4,0,0,0,0,2,1,1,69,69,69,69,0,1
440,452,13,14,0.7142857143,0.7857142857,1,13.5,0.8796992481,0.9172932331,0.5714285714,0.7969924812,14,13,13,14,1,0,0,0,2,1,1,128,133,128,133,5,1
62,74,11,13,0.1538461538,0.3076923077,2,12,0.4242424242,0.5858585859,0.2307692308,0.4949494949,11,13,11,13,2,0,0,0,2,1,1,79,99,79,99,20,0
317,330,14,15,0.1333333333,0.1333333333,1,14.5,0.3405797101,0.5724637681,0.1333333333,0.4057971014,15,14,14,15,1,0,0,0,2,1,1,107,138,107,138,31,0
208,876,669,670,1,1,1,669.5,1,1,1,1,414,414,414,414,0,1,1,2,2,1,1,3432,3432,3432,3432,0,0
405,413,9,9,0.2222222222,1,0,9,0.8571428571,1,1,1,9,9,9,9,0,0,0,0,2,1,1,49,49,49,49,0,0
136,152,17,17,0.7368421053,1,0,17,0.9725274725,1,1,1,19,19,19,19,0,1,1,2,2,1,1,182,182,182,182,0,1
188,193,6,6,0.7142857143,0.8571428571,0,6,0.8405797101,0.884057971,0.2857142857,0.6231884058,7,7,7,7,0,1,1,2,2,1,1,69,61,61,69,8,1
144,153,10,10,0.4166666667,0.5833333333,0,10,0.7865168539,0.8651685393,0.1666666667,0.6404494382,12,12,12,12,0,0,0,0,2,1,1,87,89,87,89,2,1
445,454,10,12,0.25,0.3333333333,2,11,0.4096385542,0.6385542169,0.25,0.5421686747,12,10,10,12,2,0,0,0,2,1,1,83,66,66,83,17,0
24,69,46,46,1,1,0,46,1,1,1,1,40,40,40,40,0,0,0,0,0,0,0,276,276,276,276,0,1
648,665,18,19,0.8571428571,0.9047619048,1,18.5,0.8724832215,0.8926174497,0.7142857143,0.8187919463,21,20,20,21,1,0,0,0,2,1,1,149,137,137,149,12,1
84,91,8,8,0.875,0.875,0,8,0.8481012658,0.8481012658,0.75,0.8227848101,8,8,8,8,0,0,0,0,2,1,1,79,69,69,79,10,1
242,251,10,10,0.3,0.9,0,10,0.6166666667,0.8333333333,0.5,0.7,10,10,10,10,0,0,0,0,2,1,1,50,60,50,60,10,1
247,261,15,17,0.3529411765,0.7647058824,2,16,0.6279069767,0.8430232558,0.2352941176,0.5348837209,17,15,15,17,2,0,0,0,2,1,1,172,154,154,172,18,1
703,718,16,16,1,1,0,16,1,1,1,1,16,16,16,16,0,0,0,0,2,1,1,138,138,138,138,0,1
45,89,20,45,0.3333333333,0.8666666667,25,32.5,0.5974025974,0.7922077922,0.3333333333,0.5324675325,15,15,15,15,0,0,0,0,4,2,2,63,77,63,77,14,0
43,52,10,10,1,1,0,10,1,1,1,1,10,10,10,10,0,0,0,0,2,1,1,88,88,88,88,0,1
30,113,84,84,0.8472222222,1,0,84,0.972972973,1,1,1,72,72,72,72,0,0,0,0,0,0,0,518,518,518,518,0,1
486,502,17,17,1,1,0,17,1,1,1,1,17,17,17,17,0,0,0,0,2,1,1,119,119,119,119,0,1
135,182,48,48,1,1,0,48,1,1,1,1,48,48,48,48,0,0,0,0,2,1,1,318,318,318,318,0,1
10,10,1,1634,0.0357142857,0.0357142857,1633,817.5,0.9316466933,0.9316466933,0.0357142857,0.9316466933,28,1,1,28,27,1,0,1,0,0,0,2253,2099,2099,2253,154,0
48,719,672,672,1,1,0,672,1,1,1,1,576,576,576,576,0,0,0,0,0,0,0,4906,4906,4906,4906,0,1
412,433,22,22,1,1,0,22,1,1,1,1,22,22,22,22,0,0,0,0,2,1,1,154,154,154,154,0,1
233,246,13,14,0.8571428571,0.8571428571,1,13.5,0.98,0.98,0.7142857143,0.94,13,14,13,14,1,0,0,0,2,1,1,100,100,100,100,0,1
440,452,13,14,0.7142857143,0.7857142857,1,13.5,0.8796992481,0.9172932331,0.5714285714,0.7969924812,14,13,13,14,1,0,0,0,2,1,1,128,133,128,133,5,1
216,227,12,12,1,1,0,12,1,1,1,1,13,13,13,13,0,0,0,0,2,1,1,70,70,70,70,0,1
23,64,42,42,1,1,0,42,1,1,1,1,39,39,39,39,0,0,0,0,0,0,0,397,397,397,397,0,1
422,451,30,30,1,1,0,30,1,1,1,1,30,30,30,30,0,0,0,0,2,1,1,210,210,210,210,0,1
20,30,11,11,0.8181818182,0.8181818182,0,11,0.9270833333,0.9479166667,0.0909090909,0.7291666667,11,11,11,11,0,0,0,0,2,1,1,96,91,91,96,5,1
741,778,38,38,1,1,0,38,1,1,1,1,38,38,38,38,0,0,0,0,2,1,1,328,328,328,328,0,1
163,179,17,17,0.7647058824,0.8823529412,0,17,0.9387755102,0.9523809524,0.8823529412,0.9523809524,17,17,17,17,0,1,0,1,2,1,1,142,147,142,147,5,1
278,358,81,81,1,1,0,81,1,1,1,1,83,83,83,83,0,0,0,0,2,1,1,2416,2416,2416,2416,0,1
76,92,17,17,0.7368421053,1,0,17,0.9695121951,1,1,1,19,19,19,19,0,1,1,2,2,1,1,164,164,164,164,0,1
705,713,9,9,1,1,0,9,1,1,1,1,9,9,9,9,0,0,0,0,2,1,1,57,57,57,57,0,1
126,138,13,13,1,1,0,13,1,1,1,1,13,13,13,13,0,0,0,0,2,1,1,111,111,111,111,0,1
90,172,83,83,1,1,0,83,1,1,1,1,83,83,83,83,0,0,0,0,2,1,1,756,756,756,756,0,1
48,719,672,672,1,1,0,672,1,1,1,1,576,576,576,576,0,0,0,0,0,0,0,4906,4906,4906,4906,0,1
546,570,25,25,0.8461538462,1,0,25,0.9759615385,1,1,1,26,26,26,26,0,1,1,2,4,2,2,208,208,208,208,0,1
472,489,17,18,0.2222222222,0.3333333333,1,17.5,0.4166666667,0.6583333333,0.2222222222,0.4833333333,17,18,17,18,1,0,0,0,2,1,1,120,119,119,120,1,0
35,37,3,3,0,1,0,3,0.8571428571,1,0.6666666667,0.9642857143,3,3,3,3,0,0,0,0,2,1,1,56,56,56,56,0,0
660,676,17,17,1,1,0,17,1,1,1,1,17,17,17,17,0,0,0,0,2,1,1,103,103,103,103,0,1
49,240,192,192,0.9936708861,0.9936708861,0,192,0.9979324604,0.9979324604,0.9936708861,0.9965541006,158,158,158,158,0,1,1,2,2,1,1,1451,1448,1448,1451,3,1
17,20,4,4,0.25,0.75,0,4,0.8913043478,0.9565217391,0.75,0.9565217391,4,4,4,4,0,0,1,1,2,1,1,46,44,44,46,2,1
91,98,6,8,0.5,0.5,2,7,0.6774193548,0.7096774194,0.5,0.7096774194,6,8,6,8,2,0,0,0,2,1,1,24,31,24,31,7,0
595,605,11,11,0.8461538462,0.9230769231,0,11,0.9797979798,0.9898989899,0.9230769231,0.9898989899,13,13,13,13,0,0,0,0,2,1,1,99,99,99,99,0,1
771,789,19,19,0,0,0,19,0.3333333333,0.5833333333,0,0.5,19,19,19,19,0,0,0,0,2,1,1,228,171,171,228,57,0
237,254,18,18,1,1,0,18,1,1,1,1,18,18,18,18,0,2,2,4,2,1,1,117,117,117,117,0,1
106,122,17,17,0.8421052632,1,0,17,0.9826589595,1,1,1,19,19,19,19,0,1,1,2,2,1,1,173,173,173,173,0,1
41,92,52,52,0.9803921569,0.9803921569,0,52,0.9847715736,0.9873096447,0.9803921569,0.9847715736,51,51,51,51,0,1,1,2,4,2,2,394,390,390,394,4,0
61,90,30,30,0.9090909091,1,0,30,0.989010989,1,1,1,33,33,33,33,0,2,2,4,2,1,1,273,273,273,273,0,1
483,506,24,24,0.4166666667,0.7083333333,0,24,0.6953125,0.8671875,0.5,0.75,24,24,24,24,0,0,0,0,2,1,1,116,128,116,128,12,1
432,446,15,15,0.9411764706,0.9411764706,0,15,0.9449541284,0.9541284404,0.9411764706,0.9541284404,17,17,17,17,0,0,0,0,2,1,1,106,109,106,109,3,1
316,331,16,16,1,1,0,16,1,1,1,1,17,17,17,17,0,0,0,0,2,1,1,108,108,108,108,0,1
780,793,14,14,0,1,0,14,0.5714285714,1,1,1,14,14,14,14,0,0,0,0,2,1,1,98,98,98,98,0,0
279,284,6,6,0,0.1666666667,0,6,0.6052631579,0.8684210526,0,0.7368421053,6,6,6,6,0,0,0,0,2,1,1,38,38,38,38,0,0
3,21,7,19,0,0.6666666667,12,13,0.5294117647,0.9411764706,0.6666666667,0.8431372549,6,6,6,6,0,1,1,2,0,0,0,51,49,49,51,2,0
178,189,10,12,0.5833333333,0.75,2,11,0.6219512195,0.6707317073,0.25,0.5365853659,10,12,10,12,2,0,0,0,2,1,1,56,82,56,82,26,1
53,166,114,114,0.9495798319,0.9495798319,0,114,0.9944495837,0.9944495837,0.9495798319,0.9944495837,119,119,119,119,0,0,0,0,2,1,1,1076,1081,1076,1081,5,1
484,501,18,18,1,1,0,18,1,1,1,1,18,18,18,18,0,1,1,2,2,1,1,164,164,164,164,0,1
1365,1505,140,141,0.9931034483,0.9931034483,1,140.5,0.992558672,0.992558672,0.9448275862,0.9868345736,144,145,144,145,1,0,0,0,2,1,1,1734,1747,1734,1747,13,1
590,600,11,11,1,1,0,11,1,1,1,1,11,11,11,11,0,1,1,2,2,1,1,128,128,128,128,0,1
399,408,10,10,0.6,1,0,10,0.9473684211,1,1,1,10,10,10,10,0,0,0,0,2,1,1,76,76,76,76,0,1
52,106,55,55,1,1,0,55,1,1,1,1,28,28,28,28,0,1,1,2,0,0,0,241,241,241,241,0,1
654,662,9,9,0.8181818182,0.9090909091,0,9,0.9733333333,0.9866666667,0.9090909091,0.9866666667,11,11,11,11,0,0,0,0,2,1,1,75,75,75,75,0,1
624,641,18,23,0.68,0.72,5,20.5,0.7165775401,0.7326203209,0.32,0.5989304813,25,20,20,25,5,0,0,0,2,1,1,187,137,137,187,50,1
287,298,12,12,1,1,0,12,1,1,1,1,14,14,14,14,0,0,0,0,2,1,1,91,91,91,91,0,1
526,536,11,11,0.9090909091,1,0,11,0.9914529915,1,1,1,11,11,11,11,0,1,1,2,4,2,2,117,117,117,117,0,1
37,39,3,3,0,0.6666666667,0,3,0.75,0.9285714286,0.6666666667,0.9285714286,3,3,3,3,0,0,0,0,2,1,1,52,56,52,56,4,1
340,361,22,22,1,1,0,22,1,1,1,1,22,22,22,22,0,0,0,0,2,1,1,154,154,154,154,0,1
372,397,26,26,1,1,0,26,1,1,1,1,26,26,26,26,0,0,0,0,2,1,1,182,182,182,182,0,1
633,655,23,23,1,1,0,23,1,1,1,1,23,23,23,23,0,2,2,4,2,1,1,141,141,141,141,0,1
75,91,17,17,1,1,0,17,1,1,1,1,17,17,17,17,0,0,0,0,2,1,1,148,148,148,148,0,1
70,74,5,5,0.6666666667,1,0,5,0.9672131148,1,1,1,6,6,6,6,0,2,2,4,2,1,1,61,61,61,61,0,0
1433,1438,6,6,0.8,1,0,6,0.9791666667,1,1,1,5,5,5,5,0,1,1,2,2,1,1,48,48,48,48,0,1
31,81,51,52,0.9591836735,0.9795918367,1,51.5,0.9819277108,0.984939759,0.9795918367,0.984939759,49,48,48,49,1,1,1,2,4,2,2,332,327,327,332,5,1
77,86,8,10,0.4,0.7,2,9,0.5434782609,0.652173913,0.4,0.5652173913,8,10,8,10,2,0,0,0,2,1,1,33,46,33,46,13,0
390,395,6,6,0.6666666667,0.6666666667,0,6,0.82,0.87,0,0.72,6,6,6,6,0,0,0,0,2,1,1,88,100,88,100,12,1
105,125,21,25,0.2,0.24,4,23,0.4039735099,0.6225165563,0.2,0.4503311258,25,21,21,25,4,0,0,0,2,1,1,151,148,148,151,3,0
191,198,8,8,1,1,0,8,1,1,1,1,8,8,8,8,0,1,1,2,2,1,1,69,69,69,69,0,1
536,550,15,15,0.7333333333,0.9333333333,0,15,0.8938053097,0.9203539823,0.8,0.9026548673,15,15,15,15,0,0,0,0,2,1,1,113,109,109,113,4,1
15,20,6,7,0.1428571429,0.7142857143,1,6.5,0.5333333333,0.8666666667,0.1428571429,0.6,7,6,6,7,1,0,0,0,2,1,1,45,41,41,45,4,0
783,795,13,13,0.75,1,0,13,0.9245283019,1,0.9166666667,0.9811320755,12,12,12,12,0,1,1,2,4,2,2,53,53,53,53,0,1
367,377,11,11,0.9230769231,1,0,11,0.9892473118,1,1,1,13,13,13,13,0,0,0,0,2,1,1,93,93,93,93,0,1
74,81,6,8,0.1111111111,0.3333333333,2,7,0.4,0.6,0.3333333333,0.5125,7,9,7,9,2,0,0,0,2,1,1,66,80,66,80,14,0
25,41,17,19,0.6842105263,0.8421052632,2,18,0.8761904762,0.8952380952,0,0.6714285714,19,17,17,19,2,2,2,4,2,1,1,210,189,189,210,21,1
99,113,15,15,1,1,0,15,1,1,1,1,15,15,15,15,0,0,0,0,2,1,1,167,167,167,167,0,1
414,437,24,24,1,1,0,24,1,1,1,1,24,24,24,24,0,0,0,0,2,1,1,168,168,168,168,0,1
885,897,12,13,0.1538461538,0.3076923077,1,12.5,0.3466666667,0.6266666667,0.1538461538,0.4533333333,12,13,12,13,1,0,0,0,2,1,1,75,69,69,75,6,0
400,447,48,48,1,1,0,48,1,1,1,1,48,48,48,48,0,0,0,0,2,1,1,336,336,336,336,0,1
1151,1160,10,11,0.2727272727,0.2727272727,1,10.5,0.393442623,0.5901639344,0.2727272727,0.4426229508,11,10,10,11,1,0,0,0,2,1,1,61,58,58,61,3,0
773,782,10,11,0.7692307692,0.7692307692,1,10.5,0.8181818182,0.8484848485,0.3846153846,0.6363636364,13,12,12,13,1,0,0,0,2,1,1,99,86,86,99,13,1
347,358,11,12,0.6363636364,0.7272727273,1,11.5,0.904109589,0.9452054795,0.7272727273,0.9452054795,10,11,10,11,1,1,1,2,4,2,2,73,73,73,73,0,1
121,127,7,7,0.875,1,0,7,0.9868421053,1,1,1,8,8,8,8,0,1,1,2,2,1,1,76,76,76,76,0,0
180,192,13,13,0.5882352941,0.8823529412,0,13,0.7894736842,0.8881578947,0.8823529412,0.8881578947,17,16,16,17,1,1,1,2,2,1,1,152,136,136,152,16,1
690,691,2,2,0,0.5,0,2,0.884057971,0.9710144928,0.5,0.9710144928,2,2,2,2,0,0,0,0,2,1,1,69,67,67,69,2,1
75,100,26,26,1,1,0,26,1,1,1,1,29,29,29,29,0,3,3,6,2,1,1,247,247,247,247,0,1
353,362,10,10,0.2,0.8,0,10,0.64,0.8666666667,0.2,0.6533333333,10,10,10,10,0,0,0,0,2,1,1,70,75,70,75,5,0
122,126,5,5,0.6666666667,1,0,5,0.9677419355,1,1,1,6,6,6,6,0,2,2,4,2,1,1,62,62,62,62,0,0
232,245,14,14,1,1,0,14,1,1,1,1,14,14,14,14,0,0,0,0,2,1,1,107,107,107,107,0,1
144,222,79,79,1,1,0,79,1,1,1,1,78,78,78,78,0,0,0,0,4,2,2,590,590,590,590,0,0
227,242,10,16,0.1875,0.3125,6,13,0.2882882883,0.4594594595,0.1875,0.3243243243,10,16,10,16,6,0,0,0,2,1,1,63,111,63,111,48,0
166,182,17,17,0.7368421053,0.9473684211,0,17,0.921686747,0.9518072289,0.9473684211,0.9457831325,19,19,19,19,0,0,1,1,2,1,1,160,166,160,166,6,0
58,64,7,7,0.1428571429,0.8571428571,0,7,0.5185185185,0.9074074074,0.1428571429,0.6296296296,7,7,7,7,0,0,0,0,2,1,1,54,50,50,54,4,0
53,66,13,14,0.9285714286,0.9285714286,1,13.5,0.8484848485,0.8484848485,0.8571428571,0.8383838384,13,14,13,14,1,0,0,0,2,1,1,84,99,84,99,15,1
1196,1209,14,14,1,1,0,14,1,1,1,1,14,14,14,14,0,0,0,0,2,1,1,104,104,104,104,0,1
310,326,17,17,1,1,0,17,1,1,1,1,17,17,17,17,0,0,0,0,2,1,1,119,119,119,119,0,1
112,128,17,17,0.5263157895,0.8421052632,0,17,0.8352272727,0.8977272727,0.4210526316,0.6875,19,19,19,19,0,1,0,1,2,1,1,166,176,166,176,10,1
66,73,8,8,0.5,0.75,0,8,0.3666666667,0.45,0.5,0.3666666667,8,8,8,8,0,0,0,0,2,1,1,29,60,29,60,31,0
225,233,9,9,0.4444444444,0.7777777778,0,9,0.7872340426,0.8936170213,0.7777777778,0.8723404255,9,9,9,9,0,0,0,0,2,1,1,94,85,85,94,9,0
281,313,33,33,1,1,0,33,1,1,1,1,35,35,35,35,0,0,0,0,2,1,1,276,276,276,276,0,1
82,87,6,6,0.8571428571,1,0,6,0.9836065574,1,1,1,7,7,7,7,0,1,1,2,2,1,1,61,61,61,61,0,1
23,59,37,37,1,1,0,37,1,1,1,1,35,35,35,35,0,4,4,8,2,1,1,393,393,393,393,0,0
62,72,11,11,0,0,0,11,0.4565217391,0.7826086957,0,0.5869565217,6,6,6,6,0,0,0,0,0,0,0,46,39,39,46,7,0
255,270,16,17,0.3529411765,0.9411764706,1,16.5,0.8370786517,0.9606741573,0.7058823529,0.9269662921,17,16,16,17,1,0,0,0,2,1,1,178,171,171,178,7,0
22,41,16,20,0,0,4,18,0.2705882353,0.4588235294,0,0.3058823529,4,11,4,11,7,1,1,2,0,0,0,41,85,41,85,44,0
82,95,14,14,1,1,0,14,1,1,1,1,14,14,14,14,0,0,0,0,2,1,1,91,91,91,91,0,1
374,395,22,22,0,0,0,22,0.3333333333,0.4444444444,0,0.3434343434,22,22,22,22,0,0,0,0,1,0,1,198,110,110,198,88,0
205,218,14,14,0.6666666667,1,0,14,0.9483870968,1,0.3333333333,0.8322580645,15,15,15,15,0,0,0,0,2,1,1,155,155,155,155,0,1
136,140,5,5,0.6666666667,1,0,5,0.9677419355,1,1,1,6,6,6,6,0,2,2,4,2,1,1,62,62,62,62,0,1
220,252,33,33,1,1,0,33,1,1,1,1,34,34,34,34,0,0,0,0,2,1,1,261,261,261,261,0,1
121,127,5,7,0,0.1428571429,2,6,0.3676470588,0.6176470588,0,0.4705882353,5,7,5,7,2,0,2,2,2,1,1,57,68,57,68,11,0
383,390,8,8,0.75,1,0,8,0.9777777778,1,0.875,0.9888888889,8,8,8,8,0,0,0,0,2,1,1,90,90,90,90,0,1
190,196,7,7,0.4285714286,1,0,7,0.8974358974,1,1,1,7,7,7,7,0,0,0,0,2,1,1,39,39,39,39,0,1
84,88,4,5,0,0.1666666667,1,4.5,0.5106382979,0.7659574468,0.1666666667,0.6382978723,5,6,5,6,1,1,0,1,2,1,1,44,47,44,47,3,0
111,125,6,15,0,0,9,10.5,0.2835820896,0.5223880597,0,0.3432835821,6,13,6,13,7,0,0,0,3,1,2,53,67,53,67,14,0
70,80,10,11,0.1818181818,0.1818181818,1,10.5,0.4210526316,0.6710526316,0.1818181818,0.5789473684,10,11,10,11,1,0,0,0,3,2,1,76,75,75,76,1,0
1085,1096,12,12,0,1,0,12,0.6944444444,1,0.4166666667,0.8611111111,12,12,12,12,0,0,0,0,2,1,1,108,108,108,108,0,0
108,119,12,12,1,1,0,12,1,1,1,1,14,14,14,14,0,0,0,0,2,1,1,133,133,133,133,0,1
361,367,7,7,0.8571428571,1,0,7,0.9807692308,1,1,1,7,7,7,7,0,2,2,4,2,1,1,104,104,104,104,0,1
295,371,77,77,0,0,0,77,0.4285714286,0.7142857143,0,0.7142857143,77,77,77,77,0,0,0,0,2,1,1,385,539,385,539,154,0
13,30,18,18,0.8888888889,1,0,18,0.982300885,1,0.8333333333,0.9734513274,18,18,18,18,0,0,0,0,2,1,1,113,113,113,113,0,1
35,37,3,3,0,0.6666666667,0,3,0.7678571429,0.9285714286,0.6666666667,0.9285714286,3,3,3,3,0,0,0,0,2,1,1,52,56,52,56,4,1
570,590,19,21,0.7391304348,0.7826086957,2,20,0.8192771084,0.8614457831,0.347826087,0.6987951807,21,23,21,23,2,0,0,0,2,1,1,149,166,149,166,17,1
99,111,13,13,1,1,0,13,1,1,1,1,13,13,13,13,0,0,0,0,2,1,1,117,117,117,117,0,1
33,59,27,27,0.4074074074,0.962962963,0,27,0.801369863,0.9794520548,0.962962963,0.9794520548,27,27,27,27,0,1,0,1,2,1,1,144,146,144,146,2,1
584,588,5,5,0.3333333333,0.6666666667,0,5,0.7792207792,0.8571428571,0.6666666667,0.8181818182,5,6,5,6,1,0,1,1,2,1,1,75,77,75,77,2,1
284,299,16,18,0.3333333333,0.8888888889,2,17,0.8162162162,0.9243243243,0.6666666667,0.8918918919,18,16,16,18,2,0,0,0,2,1,1,185,171,171,185,14,1
28,36,9,9,1,1,0,9,1,1,1,1,11,11,11,11,0,0,0,0,2,1,1,114,114,114,114,0,1
159,173,15,15,1,1,0,15,1,1,1,1,15,15,15,15,0,0,0,0,2,1,1,190,190,190,190,0,1
1128,1141,14,14,1,1,0,14,1,1,1,1,14,14,14,14,0,0,0,0,2,1,1,116,116,116,116,0,1
146,162,17,17,0.6315789474,0.9473684211,0,17,0.9075144509,0.9537572254,0.8421052632,0.9421965318,19,19,19,19,0,1,1,2,2,1,1,165,173,165,173,8,1
804,809,6,6,0.5,0.8333333333,0,6,0.5666666667,0.7333333333,0.8333333333,0.7333333333,6,6,6,6,0,0,0,0,2,1,1,30,23,23,30,7,0
73,82,10,10,1,1,0,10,1,1,1,1,10,10,10,10,0,0,0,0,2,1,1,62,62,62,62,0,1
168,176,9,21,0,0,12,15,0.2682926829,0.4756097561,0,0.3414634146,15,9,9,15,6,0,0,0,3,2,1,77,82,77,82,5,0
184,198,15,15,1,1,0,15,1,1,1,1,15,15,15,15,0,0,0,0,2,1,1,198,198,198,198,0,1
34,38,5,5,0,0.8,0,5,0.65,0.8,0.8,0.8,5,5,5,5,0,1,0,1,2,1,1,65,80,65,80,15,1
1214,1226,13,13,0.8461538462,0.9230769231,0,13,0.9166666667,0.9537037037,0.4615384615,0.8055555556,13,13,13,13,0,2,2,4,2,1,1,103,108,103,108,5,1
90,172,83,83,1,1,0,83,1,1,1,1,83,83,83,83,0,0,0,0,2,1,1,756,756,756,756,0,1
346,377,32,32,1,1,0,32,1,1,1,1,32,32,32,32,0,0,0,0,2,1,1,398,398,398,398,0,1
373,403,31,31,1,1,0,31,1,1,1,1,31,31,31,31,0,1,1,2,2,1,1,129,129,129,129,0,1
549,571,23,23,1,1,0,23,1,1,1,1,23,23,23,23,0,0,0,0,2,1,1,210,210,210,210,0,1
8,16,3,9,0,0,6,6,0.4705882353,0.7647058824,0,0.7647058824,2,2,2,2,0,1,1,2,0,0,0,17,15,15,17,2,0
62,66,5,5,0.6666666667,1,0,5,0.9672131148,1,1,1,6,6,6,6,0,2,2,4,2,1,1,61,61,61,61,0,1
10,10,1,72,0.0357142857,0.0357142857,71,36.5,0.9316466933,0.9316466933,0.0357142857,0.9316466933,28,1,1,28,27,1,0,1,0,0,0,2253,2099,2099,2253,154,0
495,509,15,15,1,1,0,15,1,1,1,1,16,16,16,16,0,0,0,0,2,1,1,173,173,173,173,0,1
269,278,10,10,0.8,1,0,10,0.9875776398,1,1,1,10,10,10,10,0,1,1,2,2,1,1,161,161,161,161,0,1
152,160,9,9,0.7,0.7,0,9,0.8222222222,0.8222222222,0,0.5666666667,9,10,9,10,1,1,0,1,2,1,1,81,90,81,90,9,1
132,155,24,24,0.64,0.84,0,24,0.8925925926,0.9333333333,0.68,0.8925925926,25,25,25,25,0,0,0,0,2,1,1,270,266,266,270,4,1
70,77,8,8,1,1,0,8,1,1,1,1,9,9,9,9,0,1,1,2,2,1,1,77,77,77,77,0,1
48,62,15,15,1,1,0,15,1,1,1,1,16,16,16,16,0,0,0,0,2,1,1,119,119,119,119,0,1
142,194,53,53,1,1,0,53,1,1,1,1,50,50,50,50,0,1,1,2,2,1,1,324,324,324,324,0,1
146,162,17,17,0.5263157895,0.9473684211,0,17,0.9248554913,0.9884393064,0.9473684211,0.9884393064,19,19,19,19,0,1,1,2,2,1,1,173,173,173,173,0,0
88,103,12,16,0.125,0.1875,4,14,0.3647058824,0.6,0.125,0.4588235294,12,16,12,16,4,0,0,0,2,1,1,85,80,80,85,5,0
4,205,202,202,1,1,0,202,1,1,1,1,183,183,183,183,0,0,0,0,0,0,0,1536,1536,1536,1536,0,1
380,453,74,74,0.9864864865,0.9864864865,0,74,0.986746988,0.9891566265,0.9864864865,0.986746988,74,74,74,74,0,1,0,1,2,1,1,822,830,822,830,8,0
463,472,10,10,0.3,0.4,0,10,0.3797468354,0.6075949367,0.4,0.4936708861,10,10,10,10,0,0,0,0,2,1,1,65,79,65,79,14,1
10,10,1,874,0.0357142857,0.0357142857,873,437.5,0.9316466933,0.9316466933,0.0357142857,0.9316466933,28,1,1,28,27,1,0,1,0,0,0,2253,2099,2099,2253,154,0
139,151,13,13,1,1,0,13,1,1,1,1,15,15,15,15,0,0,0,0,2,1,1,114,114,114,114,0,1
4,205,202,202,1,1,0,202,1,1,1,1,183,183,183,183,0,0,0,0,0,0,0,1536,1536,1536,1536,0,1
28,34,7,14,0,0.0769230769,7,10.5,0.3205128205,0.5256410256,0,0.3846153846,13,7,7,13,6,1,0,1,3,2,1,78,65,65,78,13,0
666,675,10,11,0.2727272727,0.2727272727,1,10.5,0.3692307692,0.5384615385,0.2727272727,0.4,11,10,10,11,1,0,0,0,2,1,1,50,65,50,65,15,0
10,10,1,100,0.0357142857,0.0357142857,99,50.5,0.9316466933,0.9316466933,0.0357142857,0.9316466933,28,1,1,28,27,1,0,1,0,0,0,2253,2099,2099,2253,154,0
86,104,19,24,0.12,0.2,5,21.5,0.2959183673,0.5,0.12,0.3367346939,25,21,21,25,4,0,0,0,2,1,1,196,139,139,196,57,0
10,221,1,212,0.0384615385,0.0384615385,211,106.5,0.9333036905,0.9333036905,0.0384615385,0.9333036905,1,26,1,26,25,0,1,1,0,0,0,2099,2249,2099,2249,150,0
60,79,20,22,0.2272727273,0.2727272727,2,21,0.3636363636,0.5606060606,0.1818181818,0.4318181818,22,20,20,22,2,0,0,0,2,1,1,132,118,118,132,14,0
585,592,8,8,1,1,0,8,1,1,1,1,9,9,9,9,0,1,1,2,2,1,1,52,52,52,52,0,1
1382,1399,16,18,0.1428571429,0.2380952381,2,17,0.3197278912,0.5510204082,0.2380952381,0.4013605442,17,21,17,21,4,0,0,0,2,1,1,147,141,141,147,6,0
239,265,11,27,0.1111111111,0.1111111111,16,19,0.2152466368,0.3677130045,0.1111111111,0.2600896861,11,27,11,27,16,0,0,0,2,1,1,104,223,104,223,119,0
300,338,39,39,0.9487179487,0.9487179487,0,39,0.9730639731,0.9730639731,0.8205128205,0.9562289562,39,39,39,39,0,0,0,0,2,1,1,296,297,296,297,1,1
1420,1437,14,18,0.5,0.7222222222,4,16,0.71875,0.7625,0.2777777778,0.65,14,18,14,18,4,0,0,0,2,1,1,122,160,122,160,38,0
442,471,30,30,1,1,0,30,1,1,1,1,30,30,30,30,0,0,0,0,2,1,1,210,210,210,210,0,0
667,685,18,19,0.8571428571,0.9047619048,1,18.5,0.8724832215,0.8926174497,0.7142857143,0.8187919463,20,21,20,21,1,0,0,0,2,1,1,137,149,137,149,12,1
442,452,11,11,0.1818181818,0.7272727273,0,11,0.5612244898,0.7755102041,0.3636363636,0.6734693878,11,11,11,11,0,0,0,0,2,1,1,90,98,90,98,8,0
326,337,12,12,0.25,0.25,0,12,0.2117647059,0.4,0.25,0.3058823529,12,12,12,12,0,0,0,0,2,1,1,85,59,59,85,26,0
108,124,17,17,0.5263157895,0.8421052632,0,17,0.8352272727,0.8977272727,0.4210526316,0.6875,19,19,19,19,0,0,1,1,2,1,1,176,166,166,176,10,1
1011,1022,12,12,0.9230769231,0.9230769231,0,12,0.9833333333,0.9916666667,0.8461538462,0.975,13,13,13,13,0,0,0,0,2,1,1,120,120,120,120,0,1
996,1080,43,85,0,0,42,64,0.25,0.5,0,0.5,43,43,43,43,0,0,0,0,1,1,0,301,344,301,344,43,0
524,546,21,23,0.84,0.88,2,22,0.8395721925,0.871657754,0.68,0.807486631,23,25,23,25,2,0,0,0,2,1,1,166,187,166,187,21,1
425,436,12,13,0.5384615385,0.9230769231,1,12.5,0.8429752066,0.9256198347,0.3846153846,0.7685950413,13,12,12,13,1,0,0,0,2,1,1,121,112,112,121,9,0
1440,1458,17,19,0.4736842105,0.8421052632,2,18,0.813253012,0.9036144578,0.3157894737,0.7530120482,17,19,17,19,2,0,0,0,2,1,1,153,166,153,166,13,1
87,103,17,17,1,1,0,17,1,1,1,1,17,17,17,17,0,0,0,0,2,1,1,144,144,144,144,0,1
629,646,18,19,0.8571428571,0.9047619048,1,18.5,0.8724832215,0.8926174497,0.7142857143,0.8187919463,21,20,20,21,1,0,0,0,2,1,1,149,137,137,149,12,1
345,368,24,24,1,1,0,24,1,1,1,1,24,24,24,24,0,0,0,0,2,1,1,168,168,168,168,0,0
1006,1019,14,17,0.4705882353,0.8235294118,3,15.5,0.7320261438,0.7843137255,0.2941176471,0.6732026144,17,14,14,17,3,0,0,0,2,1,1,153,120,120,153,33,1
788,809,22,22,0.2173913043,0.2173913043,0,22,0.3461538462,0.5769230769,0.2173913043,0.4010989011,23,22,22,23,1,0,0,0,2,1,1,182,157,157,182,25,0
145,176,20,32,0.40625,0.40625,12,26,0.9454545455,0.9454545455,0.40625,0.9454545455,20,32,20,32,12,1,1,2,2,1,1,209,220,209,220,11,0
297,306,10,10,1,1,0,10,1,1,1,1,10,10,10,10,0,0,0,0,2,1,1,77,77,77,77,0,1
251,257,6,7,0.4285714286,0.7142857143,1,6.5,0.4358974359,0.5641025641,0.7142857143,0.5641025641,6,7,6,7,1,0,0,0,2,1,1,23,39,23,39,16,0
50,58,9,9,0.9090909091,1,0,9,0.9892473118,1,1,1,11,11,11,11,0,1,1,2,2,1,1,93,93,93,93,0,1
838,864,27,27,1,1,0,27,1,1,1,1,27,27,27,27,0,0,0,0,2,1,1,193,193,193,193,0,1
110,197,88,88,1,1,0,88,1,1,1,1,88,88,88,88,0,0,0,0,2,1,1,484,484,484,484,0,1
203,212,10,11,0.0909090909,0.0909090909,1,10.5,0.3157894737,0.5438596491,0.0909090909,0.4035087719,11,10,10,11,1,1,1,2,2,1,1,57,53,53,57,4,0
94,111,18,18,0.9411764706,1,0,18,0.9927007299,1,0.9411764706,0.9854014599,17,17,17,17,0,1,1,2,4,2,2,137,137,137,137,0,1
178,189,10,12,0.2307692308,0.3076923077,2,11,0.4105263158,0.6210526316,0.2307692308,0.4736842105,11,13,11,13,2,0,0,0,2,1,1,95,90,90,95,5,1
635,654,20,20,0.9523809524,0.9523809524,0,20,0.9912280702,0.9912280702,0.9523809524,0.9912280702,21,21,21,21,0,0,0,0,2,1,1,114,114,114,114,0,1
163,173,11,11,0.2727272727,0.2727272727,0,11,0.3417721519,0.5316455696,0.2727272727,0.3797468354,11,11,11,11,0,0,0,0,2,1,1,61,79,61,79,18,0
63,79,14,17,0.6470588235,0.7647058824,3,15.5,0.704,0.728,0.5294117647,0.688,14,17,14,17,3,0,0,0,2,1,1,91,125,91,125,34,1
469,500,32,32,1,1,0,32,1,1,1,1,32,32,32,32,0,0,0,0,2,1,1,224,224,224,224,0,0
35,50,16,17,0.9411764706,0.9411764706,1,16.5,0.9043478261,0.9043478261,0.6470588235,0.8608695652,17,16,16,17,1,0,0,0,2,1,1,115,104,104,115,11,1
424,455,32,32,1,1,0,32,1,1,1,1,32,32,32,32,0,0,0,0,2,1,1,224,224,224,224,0,0
339,364,19,26,0.2307692308,0.2692307692,7,22.5,0.4135338346,0.5639097744,0.1923076923,0.4436090226,19,26,19,26,7,0,0,0,2,1,1,109,133,109,133,24,0
570,590,21,21,1,1,0,21,1,1,1,1,23,23,23,23,0,0,0,0,2,1,1,166,166,166,166,0,1
208,235,23,28,0.7142857143,0.7857142857,5,25.5,0.8105726872,0.8325991189,0.25,0.5991189427,23,28,23,28,5,0,0,0,2,1,1,189,227,189,227,38,1
538,548,11,11,0.9166666667,0.9166666667,0,11,0.9857142857,0.9857142857,0.1666666667,0.7714285714,12,12,12,12,0,3,3,6,2,1,1,70,70,70,70,0,1
167,176,10,12,0.1666666667,0.25,2,11,0.3604651163,0.5697674419,0.1666666667,0.4186046512,12,10,10,12,2,0,0,0,2,1,1,86,65,65,86,21,0
406,431,26,26,1,1,0,26,1,1,1,1,26,26,26,26,0,0,0,0,2,1,1,182,182,182,182,0,0
629,646,18,18,0.9,1,0,18,0.9854014599,1,1,1,20,20,20,20,0,0,0,0,2,1,1,137,137,137,137,0,1
762,770,9,11,0.6153846154,0.7692307692,2,10,0.7171717172,0.7474747475,0.3846153846,0.5757575758,13,11,11,13,2,0,0,0,2,1,1,99,75,75,99,24,0
184,198,15,17,0.7647058824,0.8235294118,2,16,0.845814978,0.8634361233,0.7647058824,0.8546255507,17,15,15,17,2,0,0,0,2,1,1,227,198,198,227,29,1
58,104,20,47,0.0425531915,0.1276595745,27,33.5,0.3146853147,0.458041958,0.0425531915,0.3111888112,20,47,20,47,27,0,0,0,2,1,1,183,286,183,286,103,0
41,49,9,9,1,1,0,9,1,1,1,1,9,9,9,9,0,0,0,0,2,1,1,49,49,49,49,0,1
550,558,9,11,0.6153846154,0.8461538462,2,10,0.7272727273,0.7575757576,0.3846153846,0.5858585859,13,11,11,13,2,0,0,0,2,1,1,99,75,75,99,24,1
64,67,4,4,0.25,1,0,4,0.9347826087,1,1,1,4,4,4,4,0,0,0,0,2,1,1,46,46,46,46,0,1
1245,1265,20,21,0.2857142857,0.9523809524,1,20.5,0.859223301,0.9660194175,0.6666666667,0.932038835,20,21,20,21,1,0,0,0,2,1,1,199,206,199,206,7,1
120,126,7,7,0.75,1,0,7,0.9718309859,1,1,1,8,8,8,8,0,0,0,0,2,1,1,71,71,71,71,0,0
545,554,10,10,0.7272727273,0.8181818182,0,10,0.8787878788,0.9166666667,0.8181818182,0.9090909091,11,11,11,11,0,0,0,0,2,1,1,124,132,124,132,8,1
10,10,1,471,0.0357142857,0.0357142857,470,236,0.9316466933,0.9316466933,0.0357142857,0.9316466933,28,1,1,28,27,1,0,1,0,0,0,2253,2099,2099,2253,154,0
53,166,114,114,0.9495798319,0.9495798319,0,114,0.9944495837,0.9944495837,0.9495798319,0.9944495837,119,119,119,119,0,0,0,0,2,1,1,1076,1081,1076,1081,5,1
1697,1702,6,6,0.125,0.125,0,6,0.375,0.5909090909,0,0.4431818182,7,8,7,8,1,2,0,2,2,1,1,73,88,73,88,15,0
901,919,19,19,1,1,0,19,1,1,1,1,19,19,19,19,0,3,3,6,2,1,1,171,171,171,171,0,1
66,98,33,33,0.7567567568,1,0,33,0.9717868339,1,1,1,37,37,37,37,0,1,1,2,2,1,1,319,319,319,319,0,1
37,37,1,1,1,1,0,1,1,1,1,1,1,1,1,1,0,0,0,0,0,0,0,2094,2094,2094,2094,0,1
522,546,25,25,0.8461538462,1,0,25,0.9759615385,1,1,1,26,26,26,26,0,1,1,2,4,2,2,208,208,208,208,0,1
944,955,12,12,1,1,0,12,1,1,1,1,12,12,12,12,0,1,1,2,2,1,1,70,70,70,70,0,1
30,42,9,13,0.1538461538,0.3076923077,4,11,0.3333333333,0.5632183908,0.2307692308,0.4367816092,10,13,10,13,3,0,0,0,2,1,1,71,87,71,87,16,0
489,498,10,11,0.7692307692,0.7692307692,1,10.5,0.8181818182,0.8282828283,0.2307692308,0.6262626263,13,12,12,13,1,0,0,0,2,1,1,99,83,83,99,16,1
417,422,6,6,0.6666666667,1,0,6,0.9444444444,1,1,1,6,6,6,6,0,0,0,0,2,1,1,54,54,54,54,0,1
14,44,20,31,0.0909090909,0.2727272727,11,25.5,0.3417721519,0.5696202532,0.0909090909,0.3670886076,11,11,11,11,0,3,2,5,2,1,1,65,79,65,79,14,0
572,588,17,17,1,1,0,17,1,1,1,1,17,17,17,17,0,0,0,0,2,1,1,119,119,119,119,0,0
11,25,15,15,1,1,0,15,1,1,1,1,15,15,15,15,0,1,1,2,2,1,1,137,137,137,137,0,1
46,130,85,85,0.8888888889,0.8888888889,0,85,0.9871630295,0.9871630295,0.8888888889,0.9871630295,90,90,90,90,0,0,0,0,2,1,1,769,779,769,779,10,1
641,660,16,20,0.3,0.8,4,18,0.7487437186,0.8592964824,0.6,0.8291457286,16,20,16,20,4,0,0,0,2,1,1,171,199,171,199,28,0
343,353,11,11,0.9166666667,0.9166666667,0,11,0.9852941176,0.9852941176,0.9166666667,0.9852941176,12,12,12,12,0,0,0,0,2,1,1,68,68,68,68,0,1
311,317,7,7,0.375,0.75,0,7,0.6901408451,0.8028169014,0.25,0.661971831,8,8,8,8,0,0,0,0,2,1,1,71,60,60,71,11,0
444,484,41,41,1,1,0,41,1,1,1,1,41,41,41,41,0,0,0,0,2,1,1,287,287,287,287,0,0
10,558,1,549,0.0384615385,0.0384615385,548,275,0.9333036905,0.9333036905,0.0384615385,0.9333036905,1,26,1,26,25,0,1,1,0,0,0,2099,2249,2099,2249,150,0
307,357,50,51,1,1,1,50.5,1,1,1,1,15,15,15,15,0,1,1,2,4,2,2,104,104,104,104,0,1
190,194,5,6,0,0,1,5.5,0.3787878788,0.5909090909,0,0.5,7,5,5,7,2,5,1,6,2,1,1,66,55,55,66,11,0
687,703,17,17,1,1,0,17,1,1,1,1,17,17,17,17,0,0,0,0,2,1,1,84,84,84,84,0,1
1083,1085,3,3,0.6666666667,1,0,3,0.95,1,1,1,6,6,6,6,0,0,0,0,2,1,1,40,40,40,40,0,0
155,168,14,14,0,1,0,14,0.5714285714,1,1,1,14,14,14,14,0,0,0,0,2,1,1,98,98,98,98,0,0
453,478,26,26,0,0,0,26,0.1904761905,0.2857142857,0,0.2380952381,26,26,26,26,0,0,0,0,2,1,1,546,182,182,546,364,0
228,238,11,14,0.1538461538,0.3846153846,3,12.5,0.3289473684,0.5,0.1538461538,0.3815789474,13,11,11,13,2,3,0,3,3,2,1,76,55,55,76,21,0
402,432,31,31,0.9375,0.9375,0,31,0.9387755102,0.9387755102,0.28125,0.6598639456,32,31,31,32,1,1,1,2,2,1,1,294,276,276,294,18,0
777,781,5,5,0.8571428571,0.8571428571,0,5,0.875,0.8875,0.8571428571,0.8875,7,7,7,7,0,2,2,4,2,1,1,80,72,72,80,8,0
91,96,6,14,0.1818181818,0.1818181818,8,10,0.4698795181,0.6144578313,0.1818181818,0.5301204819,11,6,6,11,5,0,0,0,4,2,2,83,67,67,83,16,0
199,354,156,156,0.9915254237,0.9915254237,0,156,0.9911154985,0.9921026654,0.1101694915,0.6663376111,118,118,118,118,0,1,1,2,2,1,1,1005,1013,1005,1013,8,0
629,646,18,18,1,1,0,18,1,1,1,1,20,20,20,20,0,0,0,0,2,1,1,137,137,137,137,0,1
232,267,23,36,0.1891891892,0.1891891892,13,29.5,0.2925764192,0.4890829694,0.1891891892,0.3449781659,25,37,25,37,12,0,0,0,2,1,1,202,229,202,229,27,0
1,11,11,12,0,0.2,1,11.5,0.425,0.725,0,0.4875,6,10,6,10,4,1,0,1,0,0,0,63,80,63,80,17,0
368,397,21,30,0.1290322581,0.1290322581,9,25.5,0.3155555556,0.5466666667,0.1290322581,0.3555555556,21,31,21,31,10,0,0,0,2,1,1,219,225,219,225,6,1
1,21,21,21,0.8333333333,1,0,21,0.9756097561,1,1,1,18,18,18,18,0,0,0,0,0,0,0,164,164,164,164,0,1
222,254,33,33,1,1,0,33,1,1,1,1,34,34,34,34,0,0,0,0,2,1,1,261,261,261,261,0,1
506,524,19,19,1,1,0,19,1,1,1,1,20,20,20,20,0,0,0,0,2,1,1,235,235,235,235,0,1
130,142,13,13,0.5384615385,0.8461538462,0,13,0.8535031847,0.8917197452,0.8461538462,0.8917197452,13,13,13,13,0,0,0,0,2,1,1,140,157,140,157,17,1
459,501,43,43,1,1,0,43,1,1,1,1,46,46,46,46,0,0,0,0,2,1,1,314,314,314,314,0,1
343,356,14,14,1,1,0,14,1,1,1,1,16,16,16,16,0,0,0,0,2,1,1,122,122,122,122,0,1
705,723,19,19,1,1,0,19,1,1,1,1,20,20,20,20,0,0,0,0,2,1,1,93,93,93,93,0,1
88,96,9,9,0.7,1,0,9,0.9659090909,1,1,1,10,10,10,10,0,1,1,2,2,1,1,88,88,88,88,0,1
135,182,48,48,1,1,0,48,1,1,1,1,48,48,48,48,0,0,0,0,2,1,1,318,318,318,318,0,1
87,89,3,3,0,1,0,3,0.8166666667,1,0.6666666667,0.9666666667,3,3,3,3,0,0,0,0,2,1,1,60,60,60,60,0,1
389,410,22,22,1,1,0,22,1,1,1,1,22,22,22,22,0,0,0,0,2,1,1,154,154,154,154,0,1
469,492,24,24,1,1,0,24,1,1,1,1,24,24,24,24,0,0,0,0,2,1,1,168,168,168,168,0,0
462,491,30,30,1,1,0,30,1,1,1,1,30,30,30,30,0,0,0,0,2,1,1,210,210,210,210,0,1
949,961,13,13,0.8461538462,1,0,13,0.9805825243,1,1,1,13,13,13,13,0,2,2,4,2,1,1,103,103,103,103,0,1
64,66,3,3,0,1,0,3,0.9,1,1,1,3,3,3,3,0,0,0,0,2,1,1,60,60,60,60,0,0
435,447,13,13,1,1,0,13,1,1,1,1,13,13,13,13,0,0,0,0,2,1,1,133,133,133,133,0,1
171,176,6,6,0.8333333333,0.8333333333,0,6,0.8852459016,0.9180327869,0.8333333333,0.8852459016,6,6,6,6,0,0,0,0,2,1,1,56,61,56,61,5,1
316,325,10,10,1,1,0,10,1,1,1,1,10,10,10,10,0,0,0,0,2,1,1,119,119,119,119,0,1
851,877,27,27,0.9259259259,1,0,27,0.9896373057,1,1,1,27,27,27,27,0,0,0,0,2,1,1,193,193,193,193,0,1
46,51,6,6,0.1666666667,1,0,6,0.7924528302,1,1,1,6,6,6,6,0,1,1,2,2,1,1,53,53,53,53,0,1
197,206,10,10,0.4,0.6,0,10,0.5714285714,0.7142857143,0.5,0.6428571429,10,10,10,10,0,0,0,0,3,1,2,39,42,39,42,3,1
293,334,42,42,0.9545454545,1,0,42,0.9962894249,1,1,1,44,44,44,44,0,0,0,0,2,1,1,539,539,539,539,0,1
376,386,11,11,0.5454545455,1,0,11,0.8421052632,1,1,1,11,11,11,11,0,0,0,0,2,1,1,57,57,57,57,0,1
35,46,12,12,0.9166666667,0.9166666667,0,12,0.9895833333,0.9895833333,0.9166666667,0.9895833333,12,12,12,12,0,0,0,0,2,1,1,96,96,96,96,0,1
522,544,23,23,1,1,0,23,1,1,1,1,25,25,25,25,0,0,0,0,2,1,1,187,187,187,187,0,1
648,665,18,18,1,1,0,18,1,1,1,1,20,20,20,20,0,0,0,0,2,1,1,137,137,137,137,0,1
183,197,15,15,1,1,0,15,1,1,1,1,16,16,16,16,0,0,0,0,2,1,1,119,119,119,119,0,1
592,614,23,23,0.6956521739,0.9565217391,0,23,0.9427312775,0.9779735683,0.8260869565,0.9647577093,23,23,23,23,0,0,0,0,2,1,1,227,222,222,227,5,1
120,147,28,28,1,1,0,28,1,1,1,1,28,28,28,28,0,0,0,0,2,1,1,142,142,142,142,0,1
54,66,13,15,0.8,0.8,2,14,0.8640776699,0.8737864078,0.7333333333,0.854368932,15,13,13,15,2,0,0,0,2,1,1,103,94,94,103,9,1
293,309,17,21,0.8095238095,0.8095238095,4,19,0.825,0.825,0.5238095238,0.7125,21,17,17,21,4,0,0,0,2,1,1,160,132,132,160,28,1
69,74,6,6,0.5,1,0,6,0.9444444444,1,1,1,6,6,6,6,0,0,0,0,2,1,1,72,72,72,72,0,0
651,705,55,55,1,1,0,55,1,1,1,1,46,46,46,46,0,3,3,6,4,2,2,234,234,234,234,0,1
216,225,10,10,0.3,0.3,0,10,0.4444444444,0.6349206349,0.3,0.5238095238,10,10,10,10,0,0,0,0,2,1,1,63,62,62,63,1,1
306,335,30,30,0,0,0,30,0.1904761905,0.2857142857,0,0.2380952381,30,30,30,30,0,0,0,0,2,1,1,630,210,210,630,420,0
86,102,17,17,0.7368421053,1,0,17,0.9698795181,1,1,1,19,19,19,19,0,1,1,2,2,1,1,166,166,166,166,0,1
208,241,34,34,1,1,0,34,1,1,1,1,35,35,35,35,0,0,0,0,2,1,1,387,387,387,387,0,1
447,508,62,62,1,1,0,62,1,1,1,1,62,62,62,62,0,1,1,2,2,1,1,454,454,454,454,0,1
814,816,3,3,0.3333333333,0.6666666667,0,3,0.8115942029,0.8405797101,0.6666666667,0.8405797101,3,3,3,3,0,0,0,0,2,1,1,61,69,61,69,8,0
37,37,1,1,0,0,0,1,0.9995224451,0.9995224451,0,0.9995224451,1,1,1,1,0,0,0,0,0,0,0,2094,2094,2094,2094,0,1
222,226,5,5,0,0.6,0,5,0.593220339,0.7966101695,0.6,0.7966101695,5,5,5,5,0,1,0,1,2,1,1,59,49,49,59,10,1
1314,1347,16,34,0.0882352941,0.1176470588,18,25,0.1914893617,0.3262411348,0.0882352941,0.219858156,16,34,16,34,18,0,0,0,2,1,1,111,282,111,282,171,0
90,96,7,7,0.75,1,0,7,0.9718309859,1,1,1,8,8,8,8,0,0,0,0,2,1,1,71,71,71,71,0,1
342,346,5,5,0.8571428571,1,0,5,0.9875,1,0.8571428571,0.9875,7,7,7,7,0,1,1,2,2,1,1,80,80,80,80,0,1
99,105,7,7,0.875,1,0,7,0.9852941176,1,1,1,8,8,8,8,0,1,1,2,2,1,1,68,68,68,68,0,1
361,367,7,7,1,1,0,7,1,1,1,1,7,7,7,7,0,0,0,0,2,1,1,89,89,89,89,0,1
73,82,9,10,0.6,0.7,1,9.5,0.8548387097,0.8709677419,0.7,0.8709677419,9,10,9,10,1,0,0,0,2,1,1,62,62,62,62,0,0
308,320,13,16,0.25,0.3125,3,14.5,0.3913043478,0.5217391304,0.25,0.4202898551,16,13,13,16,3,0,0,0,2,1,1,69,60,60,69,9,0
152,168,17,17,0.5263157895,0.8421052632,0,17,0.8352272727,0.8977272727,0.4210526316,0.6875,19,19,19,19,0,1,0,1,2,1,1,166,176,166,176,10,1
385,406,22,22,1,1,0,22,1,1,1,1,22,22,22,22,0,0,0,0,2,1,1,154,154,154,154,0,1
282,291,10,10,1,1,0,10,1,1,1,1,10,10,10,10,0,0,0,0,2,1,1,45,45,45,45,0,1
64,80,17,17,0.9411764706,0.9411764706,0,17,0.96875,0.9765625,0.7058823529,0.921875,17,17,17,17,0,0,0,0,2,1,1,125,128,125,128,3,1
121,137,16,17,0.6666666667,0.7777777778,1,16.5,0.7192982456,0.7631578947,0.2777777778,0.5526315789,17,18,17,18,1,0,0,0,2,1,1,94,114,94,114,20,1
262,275,13,14,0.5,0.7142857143,1,13.5,0.7724550898,0.8562874251,0.4285714286,0.7365269461,13,14,13,14,1,0,0,0,2,1,1,144,167,144,167,23,1
470,496,27,27,1,1,0,27,1,1,1,1,27,27,27,27,0,1,1,2,2,1,1,158,158,158,158,0,1
73,82,10,10,1,1,0,10,1,1,1,1,10,10,10,10,0,0,0,0,2,1,1,62,62,62,62,0,1
493,502,10,10,0.875,0.875,0,10,0.8857142857,0.9142857143,0.875,0.9142857143,8,8,8,8,0,1,1,2,4,2,2,70,64,64,70,6,0
667,685,19,19,1,1,0,19,1,1,1,1,21,21,21,21,0,0,0,0,2,1,1,149,149,149,149,0,1
705,713,9,9,1,1,0,9,1,1,1,1,9,9,9,9,0,0,0,0,2,1,1,57,57,57,57,0,1
415,531,117,132,1,1,15,124.5,1,1,1,1,114,114,114,114,0,1,1,2,4,2,2,590,590,590,590,0,1
533,543,11,11,0.9090909091,1,0,11,0.9914529915,1,1,1,11,11,11,11,0,1,1,2,4,2,2,117,117,117,117,0,1
314,318,5,5,0.4,1,0,5,0.953125,1,1,1,5,5,5,5,0,1,1,2,2,1,1,64,64,64,64,0,1
145,190,46,46,0.693877551,1,0,46,0.9694989107,1,1,1,49,49,49,49,0,0,0,0,2,1,1,459,459,459,459,0,1
643,685,43,43,0.976744186,0.976744186,0,43,0.9903225806,0.9903225806,0.976744186,0.9903225806,43,43,43,43,0,0,0,0,2,1,1,310,307,307,310,3,1
590,606,17,18,0.7777777778,0.9444444444,1,17.5,0.9133858268,0.937007874,0.3333333333,0.7637795276,18,17,17,18,1,0,0,0,2,1,1,127,119,119,127,8,1
10,29,1,20,0.0588235294,0.0588235294,19,10.5,0.9553937187,0.9553937187,0.0588235294,0.9553937187,1,17,1,17,16,0,0,0,1,0,1,2099,2197,2099,2197,98,0
805,827,23,23,1,1,0,23,1,1,1,1,12,12,12,12,0,0,0,0,4,2,2,79,79,79,79,0,0
114,132,19,19,0,0,0,19,0.625,0.875,0,0.875,10,10,10,10,0,0,0,0,0,0,0,80,80,80,80,0,0
38,54,17,17,1,1,0,17,1,1,1,1,17,17,17,17,0,2,2,4,2,1,1,99,99,99,99,0,1
89,103,15,15,0.9333333333,0.9333333333,0,15,0.9350180505,0.9458483755,0.9333333333,0.9350180505,15,15,15,15,0,0,0,0,2,1,1,277,270,270,277,7,1
143,153,11,11,0.2307692308,0.8461538462,0,11,0.7254901961,0.9607843137,0.5384615385,0.9215686275,13,13,13,13,0,0,0,0,2,1,1,102,102,102,102,0,1
135,182,48,48,1,1,0,48,1,1,1,1,48,48,48,48,0,0,0,0,2,1,1,318,318,318,318,0,1
335,354,20,20,1,1,0,20,1,1,1,1,23,23,23,23,0,0,0,0,2,1,1,269,269,269,269,0,1
212,222,11,11,0.3333333333,1,0,11,0.9090909091,1,1,1,12,12,12,12,0,0,0,0,2,1,1,132,132,132,132,0,1
194,210,17,18,0.7222222222,0.8333333333,1,17.5,0.7669902913,0.8349514563,0.6111111111,0.7572815534,18,17,17,18,1,0,0,0,2,1,1,103,88,88,103,15,1
91,143,25,53,0.1132075472,0.1509433962,28,39,0.3184210526,0.5157894737,0.1132075472,0.3526315789,26,53,26,53,27,0,0,0,2,1,1,244,380,244,380,136,0
656,667,11,12,0.5833333333,0.9166666667,1,11.5,0.8859649123,0.9210526316,0.3333333333,0.7719298246,11,12,11,12,1,0,0,0,2,1,1,105,114,105,114,9,1
249,265,17,17,1,1,0,17,1,1,1,1,19,19,19,19,0,0,0,0,2,1,1,179,179,179,179,0,1
419,424,6,8,0.125,0.125,2,7,0.3461538462,0.5256410256,0.125,0.3717948718,8,6,6,8,2,1,1,2,2,1,1,78,53,53,78,25,0
56,58,3,3,0,0.6666666667,0,3,0.8076923077,0.9230769231,0.6666666667,0.9038461538,3,3,3,3,0,0,0,0,2,1,1,52,48,48,52,4,0
49,62,7,14,0,0.1538461538,7,10.5,0.3417721519,0.5443037975,0,0.417721519,7,13,7,13,6,1,2,3,3,1,2,62,79,62,79,17,0
126,141,10,16,0.1875,0.3125,6,13,0.4285714286,0.619047619,0.1875,0.4880952381,10,16,10,16,6,0,0,0,2,1,1,63,84,63,84,21,0
126,133,8,8,0.625,1,0,8,0.9436619718,1,1,1,8,8,8,8,0,0,0,0,2,1,1,71,71,71,71,0,1
42,51,10,10,0.4,0.9,0,10,0.8076923077,0.8653846154,0.9,0.8653846154,10,10,10,10,0,0,0,0,2,1,1,104,90,90,104,14,1
520,546,25,27,0.8823529412,1,2,26,0.984962406,1,1,1,17,17,17,17,0,2,2,4,2,1,1,133,133,133,133,0,1
195,201,7,7,0.875,1,0,7,0.9852941176,1,1,1,8,8,8,8,0,1,1,2,2,1,1,68,68,68,68,0,1
185,210,26,26,1,1,0,26,1,1,1,1,26,26,26,26,0,0,0,0,2,1,1,337,337,337,337,0,1
93,99,7,7,0.6666666667,0.6666666667,0,7,0.7721518987,0.7721518987,0.6666666667,0.7721518987,7,9,7,9,2,1,0,1,2,1,1,62,79,62,79,17,1
34,36,3,3,0,1,0,3,0.8846153846,1,1,1,3,3,3,3,0,0,0,0,2,1,1,52,52,52,52,0,1
560,585,26,26,0,0,0,26,0.4285714286,0.5714285714,0,0.4395604396,26,26,26,26,0,0,0,0,2,1,1,130,182,130,182,52,0
67,79,13,13,1,1,0,13,1,1,1,1,14,14,14,14,0,0,0,0,2,1,1,91,91,91,91,0,1
667,685,19,23,0.68,0.72,4,21,0.7326203209,0.7754010695,0.32,0.6256684492,25,21,21,25,4,0,0,0,2,1,1,187,149,149,187,38,1
1052,1194,143,143,0.8148148148,1,0,143,0.9677661169,1,1,1,135,135,135,135,0,0,0,0,2,1,1,1334,1334,1334,1334,0,1
54,62,9,9,1,1,0,9,1,1,1,1,9,9,9,9,0,0,0,0,2,1,1,62,62,62,62,0,1
463,495,33,33,1,1,0,33,1,1,1,1,33,33,33,33,0,1,1,2,2,1,1,205,205,205,205,0,1
36,114,46,79,0.1139240506,0.2025316456,33,62.5,0.2750491159,0.3968565815,0.1139240506,0.2966601179,46,79,46,79,33,0,0,0,2,1,1,274,509,274,509,235,0
10,37,1,28,0.0434782609,0.0434782609,27,14.5,0.9374720858,0.9374720858,0.0434782609,0.9374720858,1,23,1,23,22,0,0,0,1,0,1,2099,2239,2099,2239,140,0
5,27,23,28,0.1,0.4,5,25.5,0.5277777778,0.8472222222,0.1,0.5416666667,10,10,10,10,0,2,2,4,2,1,1,70,72,70,72,2,0
946,952,7,7,1,1,0,7,1,1,1,1,7,7,7,7,0,1,1,2,2,1,1,50,50,50,50,0,1
755,774,20,20,0.9523809524,0.9523809524,0,20,0.9912280702,0.9912280702,0.9523809524,0.9912280702,21,21,21,21,0,0,0,0,2,1,1,114,114,114,114,0,1
30,44,15,15,1,1,0,15,1,1,1,1,15,15,15,15,0,0,0,0,2,1,1,72,72,72,72,0,1
582,593,10,12,0.25,0.5,2,11,0.6181818182,0.7454545455,0.4166666667,0.6727272727,10,12,10,12,2,0,0,0,2,1,1,47,55,47,55,8,0
198,205,8,8,0.875,1,0,8,0.9824561404,1,0.875,0.9824561404,8,8,8,8,0,1,1,2,2,1,1,57,57,57,57,0,1
838,864,27,27,1,1,0,27,1,1,1,1,27,27,27,27,0,0,0,0,2,1,1,193,193,193,193,0,1
43,98,53,56,0.9375,0.96875,3,54.5,0.9900990099,0.995049505,0.96875,0.995049505,32,32,32,32,0,1,1,2,4,2,2,201,202,201,202,1,1
142,142,1,1,0,1,0,1,0.9895833333,1,1,1,1,1,1,1,0,0,0,0,2,1,1,96,96,96,96,0,0
54,62,9,9,1,1,0,9,1,1,1,1,9,9,9,9,0,0,0,0,2,1,1,62,62,62,62,0,1
396,400,5,5,0.4,0.6,0,5,0.7,0.7125,0.6,0.7125,5,5,5,5,0,0,1,1,2,1,1,80,58,58,80,22,0
199,209,10,11,0.4545454545,0.7272727273,1,10.5,0.4794520548,0.6712328767,0.2727272727,0.4931506849,10,11,10,11,1,0,0,0,2,1,1,51,73,51,73,22,0
435,464,30,30,1,1,0,30,1,1,1,1,30,30,30,30,0,0,0,0,2,1,1,210,210,210,210,0,0
38,38,1,1,0,0,0,1,0.9976303318,0.9976303318,0,0.9976303318,1,1,1,1,0,0,0,0,0,0,0,422,421,421,422,1,1
309,327,18,19,0.3157894737,0.9473684211,1,18.5,0.859375,0.9635416667,0.7368421053,0.9322916667,18,19,18,19,1,0,0,0,2,1,1,185,192,185,192,7,1
183,197,15,15,1,1,0,15,1,1,1,1,16,16,16,16,0,0,0,0,2,1,1,119,119,119,119,0,1
940,952,13,16,0.4375,0.8125,3,14.5,0.6993865031,0.7423312883,0.6875,0.736196319,16,13,13,16,3,0,0,0,2,1,1,163,121,121,163,42,0
343,357,15,15,1,1,0,15,1,1,1,1,15,15,15,15,0,0,0,0,2,1,1,173,173,173,173,0,1
522,544,23,23,0.88,1,0,23,0.9786096257,1,1,1,25,25,25,25,0,0,0,0,2,1,1,187,187,187,187,0,1
102,116,15,15,0.6470588235,0.9411764706,0,15,0.9044585987,0.949044586,0.8823529412,0.9299363057,17,17,17,17,0,0,0,0,2,1,1,157,149,149,157,8,0
113,121,4,9,0,0,5,6.5,0.323943662,0.5352112676,0,0.3521126761,4,8,4,8,4,0,1,1,3,1,2,59,71,59,71,12,0
661,677,17,17,0,0.8235294118,0,17,0.5797101449,0.8550724638,0.7058823529,0.7971014493,17,17,17,17,0,0,0,0,2,1,1,69,69,69,69,0,0
150,172,23,23,0.8846153846,0.9615384615,0,23,0.9504132231,0.9669421488,0.0769230769,0.6694214876,26,26,26,26,0,0,0,0,2,1,1,242,234,234,242,8,1
326,342,17,17,1,1,0,17,1,1,1,1,17,17,17,17,0,0,0,0,2,1,1,119,119,119,119,0,1
35,72,38,38,0.935483871,1,0,38,0.9876033058,1,1,1,31,31,31,31,0,1,1,2,4,2,2,242,242,242,242,0,0
648,667,20,20,0.8571428571,1,0,20,0.9806451613,1,1,1,21,21,21,21,0,1,1,2,4,2,2,155,155,155,155,0,1
560,566,7,7,1,1,0,7,1,1,1,1,9,9,9,9,0,0,0,0,2,1,1,74,74,74,74,0,1
45,63,19,19,0.9473684211,0.9473684211,0,19,0.9913043478,0.9913043478,0.9473684211,0.9913043478,19,19,19,19,0,0,0,0,2,1,1,114,115,114,115,1,1
42,48,7,7,0.1428571429,0.7142857143,0,7,0.4444444444,0.746031746,0.1428571429,0.5238095238,7,7,7,7,0,0,0,0,2,1,1,63,55,55,63,8,0
522,544,18,23,0.68,0.72,5,20.5,0.7165775401,0.7326203209,0.32,0.5989304813,20,25,20,25,5,0,0,0,2,1,1,137,187,137,187,50,0
202,229,22,28,0.2941176471,0.8235294118,6,25,0.6493506494,0.961038961,0.4117647059,0.7402597403,17,17,17,17,0,1,1,2,4,2,2,74,77,74,77,3,0
76,92,17,17,0.5263157895,0.8421052632,0,17,0.8352272727,0.8977272727,0.4210526316,0.6875,19,19,19,19,0,0,1,1,2,1,1,176,166,166,176,10,1
713,733,19,21,0.2272727273,0.3636363636,2,20,0.2827225131,0.4502617801,0.2272727273,0.3089005236,19,22,19,22,3,0,0,0,2,1,1,112,191,112,191,79,0
664,678,15,15,0.3846153846,1,0,15,0.8470588235,1,1,1,13,13,13,13,0,1,1,2,4,2,2,85,85,85,85,0,1
112,128,17,17,0.5263157895,0.8421052632,0,17,0.8352272727,0.8977272727,0.4210526316,0.6875,19,19,19,19,0,1,0,1,2,1,1,166,176,166,176,10,1
10,27,1,18,0.0666666667,0.0666666667,17,9.5,0.9580100411,0.9580100411,0.0666666667,0.9580100411,1,15,1,15,14,0,1,1,1,0,1,2099,2191,2099,2191,92,0
447,509,63,63,1,1,0,63,1,1,1,1,63,63,63,63,0,0,0,0,2,1,1,455,455,455,455,0,1
19,32,14,18,0.1111111111,0.1111111111,4,16,0.3193277311,0.512605042,0.1111111111,0.3613445378,18,14,14,18,4,0,0,0,2,1,1,108,119,108,119,11,0
33,69,11,37,0,0,26,24,0.1111111111,0.2083333333,0,0.1527777778,3,20,3,20,17,1,2,3,1,0,1,32,144,32,144,112,0
36,48,13,13,1,1,0,13,1,1,1,1,13,13,13,13,0,0,0,0,0,0,0,117,117,117,117,0,1
39,52,14,14,1,1,0,14,1,1,1,1,15,15,15,15,0,0,0,0,2,1,1,158,158,158,158,0,1
357,384,22,28,0.0714285714,0.2857142857,6,25,0.3176470588,0.5588235294,0.0714285714,0.3941176471,23,28,23,28,5,0,0,0,2,1,1,154,170,154,170,16,0
497,498,2,2,0,1,0,2,0.7419354839,1,1,1,2,2,2,2,0,0,0,0,2,1,1,62,62,62,62,0,0
113,124,12,12,1,1,0,12,1,1,1,1,12,12,12,12,0,0,0,0,2,1,1,67,67,67,67,0,1
506,519,12,14,0.5,0.5,2,13,0.4556962025,0.6455696203,0.5,0.5063291139,12,14,12,14,2,0,0,0,2,1,1,68,79,68,79,11,0
1206,1221,15,16,0.7368421053,0.8421052632,1,15.5,0.8837209302,0.9069767442,0.1578947368,0.6558139535,18,19,18,19,1,1,1,2,2,1,1,197,215,197,215,18,1
77,86,10,10,1,1,0,10,1,1,1,1,12,12,12,12,0,0,0,0,2,1,1,121,121,121,121,0,1
474,483,10,10,1,1,0,10,1,1,1,1,11,11,11,11,0,0,0,0,2,1,1,78,78,78,78,0,1
509,525,17,17,1,1,0,17,1,1,1,1,17,17,17,17,0,0,0,0,2,1,1,128,128,128,128,0,1
264,290,27,30,0.84375,0.84375,3,28.5,0.702970297,0.702970297,0.75,0.6897689769,32,27,27,32,5,0,0,0,2,1,1,303,213,213,303,90,1
94,112,19,21,0.6666666667,0.8571428571,2,20,0.7925925926,0.8592592593,0.380952381,0.6962962963,21,19,19,21,2,0,0,0,2,1,1,135,116,116,135,19,1
354,367,14,14,1,1,0,14,1,1,1,1,14,14,14,14,0,1,1,2,2,1,1,142,142,142,142,0,1
56,61,6,7,0.2857142857,0.7142857143,1,6.5,0.5588235294,0.7647058824,0.7142857143,0.7058823529,7,6,6,7,1,0,0,0,2,1,1,34,26,26,34,8,0
384,412,29,30,0.9,0.9,1,29.5,0.8938053097,0.9026548673,0.6666666667,0.8362831858,30,29,29,30,1,0,0,0,2,1,1,226,211,211,226,15,1
693,700,5,8,0,0.125,3,6.5,0.3823529412,0.6323529412,0.125,0.4705882353,5,8,5,8,3,0,2,2,2,1,1,61,68,61,68,7,0
316,328,13,13,0.6923076923,1,0,13,0.9183673469,1,1,1,13,13,13,13,0,1,1,2,2,1,1,49,49,49,49,0,1
427,457,31,31,1,1,0,31,1,1,1,1,31,31,31,31,0,0,0,0,2,1,1,217,217,217,217,0,0
35,37,3,3,0,0.6666666667,0,3,0.8333333333,0.9333333333,0.6666666667,0.9333333333,3,3,3,3,0,0,0,0,2,1,1,60,56,56,60,4,0
198,204,5,7,0.2857142857,0.7142857143,2,6,0.84375,0.90625,0.4285714286,0.859375,5,7,5,7,2,0,0,0,2,1,1,58,64,58,64,6,1
363,383,21,29,0.1724137931,0.275862069,8,25,0.2334801762,0.3832599119,0.1724137931,0.2555066079,29,21,21,29,8,0,0,0,2,1,1,227,109,109,227,118,0
93,102,10,10,0.1,0.7,0,10,0.462962963,0.7037037037,0.2,0.5740740741,10,10,10,10,0,0,0,0,2,1,1,82,108,82,108,26,0
243,259,17,17,1,1,0,17,1,1,1,1,19,19,19,19,0,0,0,0,2,1,1,179,179,179,179,0,1
202,232,31,31,1,1,0,31,1,1,1,1,29,29,29,29,0,1,1,2,4,2,2,210,210,210,210,0,1
780,788,9,9,1,1,0,9,1,1,1,1,9,9,9,9,0,1,1,2,2,1,1,123,123,123,123,0,1
270,279,10,11,0.7272727273,0.7272727273,1,10.5,0.6923076923,0.7230769231,0.4545454545,0.5538461538,11,10,10,11,1,0,0,0,2,1,1,65,48,48,65,17,1
782,801,20,20,0.6666666667,0.9523809524,0,20,0.9210526316,0.9912280702,0.9523809524,0.9912280702,21,21,21,21,0,0,0,0,2,1,1,114,114,114,114,0,1
7,21,13,15,0,0.1111111111,2,14,0.4210526316,0.6973684211,0,0.5526315789,9,8,8,9,1,1,2,3,1,0,1,67,76,67,76,9,0
122,138,17,17,0.5263157895,0.8421052632,0,17,0.8352272727,0.8977272727,0.4210526316,0.6875,19,19,19,19,0,1,0,1,2,1,1,166,176,166,176,10,0
125,137,13,21,0.1363636364,0.2272727273,8,17,0.3333333333,0.6180555556,0.1363636364,0.3958333333,22,13,13,22,9,0,0,0,2,1,1,132,144,132,144,12,0
370,391,22,22,0.8695652174,0.8695652174,0,22,0.9155844156,0.9155844156,0.2173913043,0.6948051948,23,23,23,23,0,1,1,2,2,1,1,145,154,145,154,9,1
278,300,23,25,0.72,0.88,2,24,0.8780487805,0.9024390244,0.4,0.6646341463,25,23,23,25,2,8,6,14,2,1,1,164,161,161,164,3,1
154,194,41,41,1,1,0,41,1,1,1,1,41,41,41,41,0,0,0,0,2,1,1,276,276,276,276,0,1
790,801,12,14,0.5,0.7857142857,2,13,0.7034482759,0.7931034483,0.3571428571,0.6689655172,14,12,12,14,2,0,0,0,2,1,1,145,115,115,145,30,1
394,404,11,11,1,1,0,11,1,1,1,1,12,12,12,12,0,0,0,0,2,1,1,159,159,159,159,0,1
116,132,17,17,0.6315789474,0.9473684211,0,17,0.9075144509,0.9537572254,0.8421052632,0.9421965318,19,19,19,19,0,1,1,2,2,1,1,173,165,165,173,8,0
1241,1252,12,12,1,1,0,12,1,1,1,1,12,12,12,12,0,0,0,0,2,1,1,98,98,98,98,0,0
5,16,7,12,0,0.1428571429,5,9.5,0.4857142857,0.8857142857,0,0.6,6,7,6,7,1,1,1,2,0,0,0,70,66,66,70,4,0
629,639,11,12,0.1666666667,0.1666666667,1,11.5,0.3577235772,0.5609756098,0.1666666667,0.4308943089,12,12,12,12,0,0,0,0,2,1,1,123,105,105,123,18,0
69,89,16,21,0.5238095238,0.7619047619,5,18.5,0.6418918919,0.7027027027,0.380952381,0.6216216216,16,21,16,21,5,0,0,0,2,1,1,104,148,104,148,44,0
19,34,16,16,1,1,0,16,1,1,1,1,16,16,16,16,0,0,0,0,2,1,1,119,119,119,119,0,1
409,443,35,37,0.8974358974,0.8974358974,2,36,0.9074733096,0.9110320285,0.8974358974,0.9039145907,39,36,36,39,3,0,0,0,2,1,1,281,260,260,281,21,1
408,422,11,15,0.4,0.7333333333,4,13,0.6535947712,0.6862745098,0.2666666667,0.5816993464,11,15,11,15,4,0,0,0,2,1,1,105,153,105,153,48,1
378,390,13,13,0.6923076923,1,0,13,0.9183673469,1,1,1,13,13,13,13,0,1,1,2,2,1,1,49,49,49,49,0,1
145,145,1,1,0,0,0,1,0.6023391813,0.9005847953,0,0.7485380117,1,1,1,1,0,0,0,0,2,1,1,156,171,156,171,15,0
250,257,8,8,0.625,0.75,0,8,0.7575757576,0.8787878788,0.625,0.7575757576,8,8,8,8,0,0,0,0,2,1,1,30,33,30,33,3,0
616,626,11,11,0.7692307692,0.9230769231,0,11,0.9494949495,0.9898989899,0.9230769231,0.9898989899,13,13,13,13,0,0,0,0,2,1,1,99,99,99,99,0,1
253,263,11,20,0.1428571429,0.1904761905,9,15.5,0.2837837838,0.4189189189,0.1428571429,0.3243243243,21,11,11,21,10,0,0,0,2,1,1,148,82,82,148,66,0
231,264,34,34,0.9411764706,0.9705882353,0,34,0.9575,0.96,0.9705882353,0.96,34,34,34,34,0,0,0,0,2,1,1,392,400,392,400,8,1
66,68,3,3,0,1,0,3,0.875,1,1,1,3,3,3,3,0,0,0,0,2,1,1,48,48,48,48,0,1
149,165,17,19,0.4736842105,0.6315789474,2,18,0.7439613527,0.8502415459,0.1052631579,0.6425120773,19,17,17,19,2,0,0,0,2,1,1,207,182,182,207,25,1
1034,1039,6,6,1,1,0,6,1,1,1,1,5,5,5,5,0,1,1,2,2,1,1,48,48,48,48,0,1
1690,1710,21,24,0.12,0.12,3,22.5,0.2819148936,0.4680851064,0.12,0.3457446809,25,21,21,25,4,0,0,0,3,1,2,188,136,136,188,52,0
449,521,73,73,1,1,0,73,1,1,1,1,71,71,71,71,0,2,2,4,2,1,1,506,506,506,506,0,1
291,299,9,9,0.4444444444,1,0,9,0.8305084746,1,1,1,9,9,9,9,0,1,1,2,2,1,1,59,59,59,59,0,1
276,298,22,23,0.1739130435,0.347826087,1,22.5,0.4632768362,0.6779661017,0.1739130435,0.5536723164,22,23,22,23,1,0,0,0,2,1,1,177,158,158,177,19,1
144,152,9,9,0.2222222222,0.8888888889,0,9,0.7567567568,0.9459459459,0.8888888889,0.9459459459,9,9,9,9,0,0,0,0,2,1,1,71,74,71,74,3,0
270,276,7,7,0.75,1,0,7,0.9718309859,1,1,1,8,8,8,8,0,0,0,0,2,1,1,71,71,71,71,0,0
95,109,15,15,1,1,0,15,1,1,1,1,17,17,17,17,0,0,0,0,2,1,1,135,135,135,135,0,1
595,607,12,13,0.6923076923,0.9230769231,1,12.5,0.9113924051,0.9873417722,0.9230769231,0.9873417722,12,13,12,13,1,0,1,1,2,1,1,78,79,78,79,1,0
6,11,6,6,0.6666666667,0.8333333333,0,6,0.8939393939,0.9696969697,0,0.5909090909,6,6,6,6,0,0,0,0,0,0,0,64,66,64,66,2,1
143,154,12,14,0.7142857143,0.7857142857,2,13,0.754491018,0.7664670659,0.5,0.7245508982,14,12,12,14,2,0,0,0,2,1,1,167,128,128,167,39,1
546,570,25,25,0.8461538462,1,0,25,0.9759615385,1,1,1,26,26,26,26,0,1,1,2,4,2,2,208,208,208,208,0,1
367,387,21,21,1,1,0,21,1,1,1,1,21,21,21,21,0,1,1,2,2,1,1,286,286,286,286,0,1
75,79,5,5,0,0.8,0,5,0.5666666667,0.85,0.8,0.8333333333,5,5,5,5,0,0,0,0,2,1,1,60,51,51,60,9,0
132,184,53,53,1,1,0,53,1,1,1,1,50,50,50,50,0,1,1,2,2,1,1,324,324,324,324,0,1
63,76,14,14,0.3571428571,0.4285714286,0,14,0.4444444444,0.6333333333,0.3571428571,0.5111111111,14,14,14,14,0,0,0,0,2,1,1,75,90,75,90,15,1
40,42,3,3,0,1,0,3,0.875,1,1,1,3,3,3,3,0,0,0,0,2,1,1,48,48,48,48,0,0
648,665,18,19,0.8571428571,0.9047619048,1,18.5,0.8724832215,0.8926174497,0.7142857143,0.8187919463,21,20,20,21,1,0,0,0,2,1,1,149,137,137,149,12,1
208,241,34,34,1,1,0,34,1,1,1,1,35,35,35,35,0,0,0,0,2,1,1,387,387,387,387,0,1
1567,1580,14,14,1,1,0,14,1,1,1,1,14,14,14,14,0,0,0,0,2,1,1,117,117,117,117,0,1
297,306,10,10,1,1,0,10,1,1,1,1,10,10,10,10,0,0,0,0,2,1,1,77,77,77,77,0,1
443,485,43,43,1,1,0,43,1,1,1,1,46,46,46,46,0,0,0,0,2,1,1,314,314,314,314,0,1
474,498,25,25,0.88,0.96,0,25,0.9756097561,0.9837398374,0.6,0.8861788618,25,25,25,25,0,0,0,0,2,1,1,242,246,242,246,4,1
493,507,15,15,1,1,0,15,1,1,1,1,16,16,16,16,0,0,0,0,2,1,1,173,173,173,173,0,1
423,428,6,6,0,1,0,6,0.9367088608,1,1,1,6,6,6,6,0,1,1,2,2,1,1,158,158,158,158,0,1
522,540,19,19,1,1,0,19,1,1,1,1,20,20,20,20,0,0,0,0,2,1,1,235,235,235,235,0,1
220,231,12,15,0.4666666667,0.8,3,13.5,0.7106918239,0.7421383648,0.4666666667,0.7232704403,15,12,12,15,3,0,0,0,2,1,1,159,118,118,159,41,1
11,35,25,25,0.9565217391,1,0,25,0.9931972789,1,1,1,23,23,23,23,0,3,3,6,2,1,1,147,147,147,147,0,1
588,592,5,5,1,1,0,5,1,1,1,1,7,7,7,7,0,2,2,4,2,1,1,59,59,59,59,0,1
459,472,14,14,1,1,0,14,1,1,1,1,14,14,14,14,0,0,0,0,2,1,1,128,128,128,128,0,1
110,126,17,17,0.7368421053,0.9473684211,0,17,0.921686747,0.9518072289,0.9473684211,0.9457831325,19,19,19,19,0,0,1,1,2,1,1,160,166,160,166,6,1
1683,1702,20,20,1,1,0,20,1,1,1,1,20,20,20,20,0,0,0,0,2,1,1,209,209,209,209,0,1
43,52,10,10,1,1,0,10,1,1,1,1,10,10,10,10,0,0,0,0,2,1,1,88,88,88,88,0,1
126,130,5,5,0,1,0,5,0.8571428571,1,1,1,5,5,5,5,0,0,0,0,2,1,1,70,70,70,70,0,0
191,198,8,8,1,1,0,8,1,1,1,1,8,8,8,8,0,0,0,0,2,1,1,43,43,43,43,0,1
403,413,11,11,0.6923076923,0.6923076923,0,11,0.8817204301,0.9032258065,0.5384615385,0.7849462366,13,13,13,13,0,0,0,0,2,1,1,91,93,91,93,2,1
312,328,17,17,0.5263157895,0.8947368421,0,17,0.8516483516,0.9120879121,0.4736842105,0.7142857143,19,19,19,19,0,1,1,2,2,1,1,182,166,166,182,16,1
35,40,6,6,0.3333333333,0.8333333333,0,6,0.7407407407,0.962962963,0.8333333333,0.962962963,6,6,6,6,0,0,0,0,2,1,1,26,27,26,27,1,1
230,236,7,7,1,1,0,7,1,1,1,1,7,7,7,7,0,0,0,0,2,1,1,51,51,51,51,0,1
34,45,12,12,1,1,0,12,1,1,1,1,14,14,14,14,0,2,2,4,2,1,1,159,159,159,159,0,1
100,113,10,14,0.4,0.6,4,12,0.9212598425,0.9448818898,0.6,0.937007874,12,15,12,15,3,0,0,0,2,1,1,121,127,121,127,6,1
66,78,13,13,1,1,0,13,1,1,1,1,13,13,13,13,0,0,0,0,2,1,1,89,89,89,89,0,1
18,28,11,11,1,1,0,11,1,1,1,1,6,6,6,6,0,1,1,2,0,0,0,103,103,103,103,0,1
85,129,36,45,0.7555555556,0.7777777778,9,40.5,0.8009708738,0.8300970874,0.4444444444,0.713592233,36,45,36,45,9,0,0,0,2,1,1,178,206,178,206,28,1
548,570,23,23,1,1,0,23,1,1,1,1,25,25,25,25,0,0,0,0,2,1,1,187,187,187,187,0,1
249,259,11,11,0.2727272727,0.2727272727,0,11,0.2427184466,0.4368932039,0.2727272727,0.3203883495,11,11,11,11,0,0,0,0,2,1,1,65,103,65,103,38,0
571,585,15,15,1,1,0,15,1,1,1,1,15,15,15,15,0,0,0,0,2,1,1,147,147,147,147,0,1
216,249,34,34,1,1,0,34,1,1,1,1,34,34,34,34,0,1,1,2,4,2,2,311,311,311,311,0,0
420,441,22,22,1,1,0,22,1,1,1,1,22,22,22,22,0,0,0,0,2,1,1,154,154,154,154,0,1
591,608,18,18,0.9444444444,0.9444444444,0,18,0.9826086957,0.9913043478,0.9444444444,0.9913043478,18,18,18,18,0,0,0,0,2,1,1,115,115,115,115,0,1
62,75,12,14,0.625,0.8125,2,13,0.7668711656,0.7975460123,0.1875,0.6319018405,14,16,14,16,2,0,0,0,2,1,1,132,163,132,163,31,1
24,69,46,46,1,1,0,46,1,1,1,1,40,40,40,40,0,0,0,0,0,0,0,276,276,276,276,0,1
1073,1082,10,11,0.5384615385,0.7692307692,1,10.5,0.7171717172,0.797979798,0.3076923077,0.6161616162,13,12,12,13,1,0,0,0,2,1,1,99,90,90,99,9,1
648,667,20,20,0.8571428571,1,0,20,0.9806451613,1,1,1,21,21,21,21,0,1,1,2,4,2,2,155,155,155,155,0,1
521,537,17,17,1,1,0,17,1,1,1,1,17,17,17,17,0,1,1,2,2,1,1,160,160,160,160,0,1
940,952,12,13,0.5384615385,0.8461538462,1,12.5,0.7933884298,0.9256198347,0.3076923077,0.7272727273,12,13,12,13,1,0,0,0,2,1,1,118,121,118,121,3,1
10,10,1,1,1,1,0,1,1,1,1,1,1,1,1,1,0,0,0,0,0,0,0,2099,2099,2099,2099,0,0
399,543,145,145,0.9857142857,1,0,145,0.9983235541,1,0.9928571429,0.999161777,140,140,140,140,0,1,1,2,2,1,1,1193,1193,1193,1193,0,0
331,342,12,12,1,1,0,12,1,1,1,1,12,12,12,12,0,0,0,0,2,1,1,79,79,79,79,0,1
254,260,7,7,0.4285714286,0.7142857143,0,7,0.5555555556,0.6388888889,0.4285714286,0.5833333333,7,7,7,7,0,0,0,0,2,1,1,36,34,34,36,2,0
389,468,80,80,1,1,0,80,1,1,1,1,80,80,80,80,0,0,0,0,2,1,1,560,560,560,560,0,1
617,671,55,55,1,1,0,55,1,1,1,1,46,46,46,46,0,3,3,6,4,2,2,234,234,234,234,0,1
114,130,17,17,0.7368421053,1,0,17,0.9698795181,1,1,1,19,19,19,19,0,1,1,2,2,1,1,166,166,166,166,0,1
311,341,31,31,1,1,0,31,1,1,1,1,31,31,31,31,0,0,0,0,2,1,1,217,217,217,217,0,1
1231,1246,16,16,0.75,1,0,16,0.9401709402,1,1,1,16,16,16,16,0,2,2,4,2,1,1,117,117,117,117,0,1
488,498,11,11,0.6923076923,0.6923076923,0,11,0.8842105263,0.9052631579,0.4615384615,0.7473684211,13,13,13,13,0,0,0,0,2,1,1,95,93,93,95,2,1
510,518,9,9,0.5,0.8,0,9,0.5972222222,0.6944444444,0.8,0.6527777778,10,9,9,10,1,0,0,0,2,1,1,72,55,55,72,17,1
739,750,12,12,1,1,0,12,1,1,1,1,13,13,13,13,0,0,0,0,2,1,1,109,109,109,109,0,1
180,199,19,20,0.3,0.3,1,19.5,0.3615384615,0.5615384615,0.3,0.4230769231,19,20,19,20,1,0,0,0,2,1,1,103,130,103,130,27,0
10,10,1,987,0.0357142857,0.0357142857,986,494,0.9316466933,0.9316466933,0.0357142857,0.9316466933,28,1,1,28,27,1,0,1,0,0,0,2253,2099,2099,2253,154,0
260,270,10,11,0.7272727273,0.8181818182,1,10.5,0.6842105263,0.7473684211,0.7272727273,0.6947368421,10,11,10,11,1,0,0,0,2,1,1,77,95,77,95,18,1
73,82,10,10,1,1,0,10,1,1,1,1,10,10,10,10,0,0,0,0,2,1,1,62,62,62,62,0,1
473,490,17,18,0.6666666667,0.8888888889,1,17.5,0.9016393443,0.9453551913,0.2222222222,0.7540983607,17,18,17,18,1,0,0,0,2,1,1,182,183,182,183,1,1
173,179,7,7,0.4285714286,0.7142857143,0,7,0.5263157895,0.7105263158,0.5714285714,0.6315789474,7,7,7,7,0,0,0,0,2,1,1,34,38,34,38,4,0
218,249,32,41,0.6511627907,0.6511627907,9,36.5,0.7624113475,0.7765957447,0.2558139535,0.5496453901,43,33,33,43,10,0,0,0,2,1,1,282,235,235,282,47,0
570,590,21,23,0.84,0.88,2,22,0.8395721925,0.871657754,0.68,0.807486631,25,23,23,25,2,0,0,0,2,1,1,187,166,166,187,21,1
1022,1038,15,17,0.5294117647,0.7647058824,2,16,0.8053691275,0.8523489933,0.2941176471,0.7382550336,15,17,15,17,2,0,0,0,2,1,1,131,149,131,149,18,0
479,566,88,88,1,1,0,88,1,1,1,1,88,88,88,88,0,0,0,0,2,1,1,782,782,782,782,0,1
693,743,51,51,1,1,0,51,1,1,1,1,56,56,56,56,0,0,0,0,2,1,1,407,407,407,407,0,1
142,173,32,32,1,1,0,32,1,1,1,1,33,33,33,33,0,0,0,0,2,1,1,235,235,235,235,0,1
114,143,30,30,0.5,0.9166666667,0,30,0.74,0.88,0.5833333333,0.74,11,12,11,12,1,1,0,1,3,1,2,44,50,44,50,6,0
121,131,10,11,0.6363636364,0.7272727273,1,10.5,0.7281553398,0.7669902913,0.3636363636,0.6504854369,10,11,10,11,1,0,0,0,2,1,1,81,103,81,103,22,0
667,674,8,8,0.625,0.75,0,8,0.6956521739,0.8260869565,0.375,0.652173913,8,8,8,8,0,0,0,0,2,1,1,40,46,40,46,6,0
667,685,18,19,0.8571428571,0.9047619048,1,18.5,0.8724832215,0.8926174497,0.7142857143,0.8187919463,20,21,20,21,1,0,0,0,2,1,1,137,149,137,149,12,0
110,197,88,88,1,1,0,88,1,1,1,1,88,88,88,88,0,0,0,0,2,1,1,484,484,484,484,0,1
104,109,6,7,0.2857142857,0.7142857143,1,6.5,0.2978723404,0.4893617021,0.4285714286,0.4042553191,7,6,6,7,1,0,0,0,2,1,1,47,26,26,47,21,0
67,75,9,9,0.4545454545,0.7272727273,0,9,0.6933333333,0.8133333333,0.2727272727,0.5733333333,11,11,11,11,0,0,0,0,2,1,1,74,75,74,75,1,0
320,331,12,13,0.6153846154,0.9230769231,1,12.5,0.8879310345,0.9224137931,0.3846153846,0.775862069,13,12,12,13,1,0,0,0,2,1,1,116,107,107,116,9,0
316,321,6,6,0.7142857143,0.7142857143,0,6,0.7142857143,0.7142857143,0.5714285714,0.6547619048,7,7,7,7,0,3,2,5,2,1,1,67,84,67,84,17,0
420,437,18,20,0.7,0.85,2,19,0.8303571429,0.8928571429,0.85,0.8928571429,20,18,18,20,2,0,0,0,2,1,1,112,100,100,112,12,1
19,34,16,16,1,1,0,16,1,1,1,1,16,16,16,16,0,0,0,0,2,1,1,119,119,119,119,0,1
486,502,17,17,0.375,1,0,17,0.8830409357,1,1,1,16,16,16,16,0,0,0,0,4,2,2,171,171,171,171,0,1
72,82,11,11,0.5454545455,0.5454545455,0,11,0.6315789474,0.6842105263,0.4545454545,0.5964912281,11,11,11,11,0,1,1,2,2,1,1,78,114,78,114,36,1
533,541,9,9,1,1,0,9,1,1,1,1,10,10,10,10,0,0,0,0,2,1,1,109,109,109,109,0,1
31,46,16,16,1,1,0,16,1,1,1,1,16,16,16,16,0,0,0,0,2,1,1,159,159,159,159,0,1
76,80,5,5,0.6666666667,1,0,5,0.9677419355,1,1,1,6,6,6,6,0,2,2,4,2,1,1,62,62,62,62,0,1
632,673,42,43,0.6136363636,0.8409090909,1,42.5,0.9166666667,0.9375,0.1136363636,0.7020833333,44,43,43,44,1,0,0,0,2,1,1,480,459,459,480,21,1
344,359,16,18,0.3333333333,0.8888888889,2,17,0.8,0.9243243243,0.6666666667,0.8918918919,18,16,16,18,2,0,0,0,2,1,1,185,171,171,185,14,1
144,150,7,7,0.4285714286,0.7142857143,0,7,0.4285714286,0.5714285714,0.4285714286,0.4489795918,7,7,7,7,0,0,0,0,2,1,1,49,32,32,49,17,0
437,466,30,30,1,1,0,30,1,1,1,1,30,30,30,30,0,0,0,0,2,1,1,210,210,210,210,0,0
236,241,6,6,0.5,1,0,6,0.8863636364,1,1,1,6,6,6,6,0,0,0,0,2,1,1,44,44,44,44,0,0
270,279,10,10,0.3,0.9,0,10,0.6704545455,0.7954545455,0.9,0.7840909091,10,10,10,10,0,1,0,1,2,1,1,88,72,72,88,16,0
103,125,23,23,0.9130434783,0.9565217391,0,23,0.9548022599,0.9717514124,0.9565217391,0.9548022599,23,23,23,23,0,0,0,0,2,1,1,177,172,172,177,5,1
20,49,30,30,0.7096774194,0.9677419355,0,30,0.8705357143,0.9821428571,0.9677419355,0.9821428571,31,31,31,31,0,1,1,2,2,1,1,220,224,220,224,4,1
189,193,5,5,1,1,0,5,1,1,1,1,5,5,5,5,0,0,0,0,2,1,1,85,85,85,85,0,1
383,394,10,12,0.3333333333,0.5833333333,2,11,0.4827586207,0.6551724138,0.4166666667,0.5,10,12,10,12,2,0,0,0,2,1,1,45,58,45,58,13,0
204,207,4,4,0,0.75,0,4,0.6973684211,0.9342105263,0.75,0.8684210526,4,4,4,4,0,0,0,0,2,1,1,74,76,74,76,2,0
255,265,11,11,0.9090909091,0.9090909091,0,11,0.9052631579,0.9157894737,0.7272727273,0.8736842105,11,11,11,11,0,0,0,0,2,1,1,95,87,87,95,8,1
135,144,10,18,0.0769230769,0.1538461538,8,14,0.3857142857,0.5428571429,0.0769230769,0.4571428571,13,11,11,13,2,0,1,1,3,2,1,67,70,67,70,3,0
294,319,26,26,1,1,0,26,1,1,1,1,26,26,26,26,0,0,0,0,2,1,1,182,182,182,182,0,1
34,44,11,11,1,1,0,11,1,1,1,1,12,12,12,12,0,1,1,2,2,1,1,84,84,84,84,0,1
1006,1019,13,14,0.5714285714,0.9285714286,1,13.5,0.8916666667,0.9416666667,0.4285714286,0.825,13,14,13,14,1,0,0,0,2,1,1,113,120,113,120,7,1
97,100,4,4,0.25,0.75,0,4,0.8913043478,0.9565217391,0.75,0.9565217391,4,4,4,4,0,1,0,1,2,1,1,44,46,44,46,2,1
1380,1387,8,8,0.625,0.875,0,8,0.8541666667,0.9166666667,0.875,0.9166666667,8,8,8,8,0,0,0,0,2,1,1,48,46,46,48,2,1
114,125,12,12,1,1,0,12,1,1,1,1,12,12,12,12,0,0,0,0,2,1,1,72,72,72,72,0,1
780,787,8,8,0.25,1,0,8,0.8571428571,1,1,1,8,8,8,8,0,0,0,0,2,1,1,105,105,105,105,0,1
1244,1287,44,44,0.4090909091,1,0,44,0.8708133971,1,0.6818181818,0.9330143541,44,44,44,44,0,0,0,0,2,1,1,209,209,209,209,0,1
77,109,33,33,0.9411764706,1,0,33,0.982300885,1,1,1,17,17,17,17,0,0,0,0,0,0,0,113,113,113,113,0,1
648,667,20,20,0.8571428571,1,0,20,0.9806451613,1,1,1,21,21,21,21,0,1,1,2,4,2,2,155,155,155,155,0,1
84,89,6,6,0.8571428571,1,0,6,0.9836065574,1,1,1,7,7,7,7,0,1,1,2,2,1,1,61,61,61,61,0,1
94,99,6,6,0.1666666667,0.8333333333,0,6,0.5641025641,0.9487179487,0.1666666667,0.6923076923,6,6,6,6,0,0,0,0,2,1,1,37,39,37,39,2,0
339,345,7,7,0.75,0.875,0,7,0.8901098901,0.9450549451,0.25,0.6923076923,8,8,8,8,0,1,1,2,2,1,1,88,91,88,91,3,1
414,433,20,20,1,1,0,20,1,1,1,1,21,21,21,21,0,0,0,0,2,1,1,189,189,189,189,0,1
126,137,12,13,0.6153846154,0.8461538462,1,12.5,0.8645833333,0.9479166667,0.2307692308,0.7395833333,13,12,12,13,1,2,1,3,2,1,1,96,91,91,96,5,1
375,405,31,31,1,1,0,31,1,1,1,1,31,31,31,31,0,0,0,0,2,1,1,217,217,217,217,0,1
63,68,6,7,0.1428571429,0.7142857143,1,6.5,0.48,0.78,0.1428571429,0.52,7,6,6,7,1,0,0,0,2,1,1,50,42,42,50,8,0
68,76,9,9,0.7,1,0,9,0.9655172414,1,1,1,10,10,10,10,0,1,1,2,2,1,1,87,87,87,87,0,1
779,789,10,11,0.7692307692,0.7692307692,1,10.5,0.8181818182,0.8282828283,0.2307692308,0.6262626263,12,13,12,13,1,0,0,0,2,1,1,82,99,82,99,17,1
277,288,12,12,0.5833333333,1,0,12,0.9553571429,1,1,1,12,12,12,12,0,0,0,0,2,1,1,112,112,112,112,0,1
1303,1310,8,8,0.625,0.875,0,8,0.7547169811,0.8679245283,0.625,0.7735849057,8,8,8,8,0,0,0,0,2,1,1,48,53,48,53,5,1
156,161,6,7,0.5714285714,0.7142857143,1,6.5,0.5882352941,0.6764705882,0.5714285714,0.5882352941,7,6,6,7,1,0,0,0,2,1,1,34,23,23,34,11,0
472,497,26,26,1,1,0,26,1,1,1,1,26,26,26,26,0,0,0,0,2,1,1,182,182,182,182,0,1
79,90,12,14,0.2857142857,0.5714285714,2,13,0.5584415584,0.7922077922,0.5,0.6623376623,14,12,12,14,2,0,0,0,2,1,1,77,70,70,77,7,0
136,141,6,6,0.5714285714,0.8571428571,0,6,0.9322033898,0.9661016949,0.8571428571,0.9661016949,7,7,7,7,0,1,1,2,2,1,1,59,59,59,59,0,1
688,696,9,9,0.6666666667,1,0,9,0.925,1,1,1,9,9,9,9,0,0,0,0,2,1,1,40,40,40,40,0,1
44,47,2,4,0,0,2,3,0.3389830508,0.6101694915,0,0.4915254237,2,4,2,4,2,0,0,0,2,1,1,59,59,59,59,0,0
121,132,9,12,0.0909090909,0.0909090909,3,10.5,0.2903225806,0.4731182796,0.0909090909,0.3548387097,10,11,10,11,1,3,1,4,3,1,2,93,70,70,93,23,0
545,557,13,13,1,1,0,13,1,1,1,1,13,13,13,13,0,0,0,0,2,1,1,154,154,154,154,0,1
104,108,4,5,0,0,1,4.5,0.3116883117,0.4935064935,0,0.3636363636,4,5,4,5,1,1,1,2,2,1,1,58,77,58,77,19,0
10,10,1,35,0.0357142857,0.0357142857,34,18,0.9316466933,0.9316466933,0.0357142857,0.9316466933,28,1,1,28,27,1,0,1,0,0,0,2253,2099,2099,2253,154,0
361,377,16,17,0.3529411765,0.9411764706,1,16.5,0.8370786517,0.9606741573,0.7058823529,0.9269662921,16,17,16,17,1,0,0,0,2,1,1,171,178,171,178,7,1
212,223,12,16,0.125,0.1875,4,14,0.2797202797,0.4755244755,0.125,0.3286713287,16,12,12,16,4,0,0,0,2,1,1,143,87,87,143,56,0
1034,1051,18,18,1,1,0,18,1,1,1,1,19,19,19,19,0,3,3,6,2,1,1,140,140,140,140,0,1
689,705,17,17,1,1,0,17,1,1,1,1,17,17,17,17,0,0,0,0,2,1,1,84,84,84,84,0,1
438,447,10,10,0.3,0.7,0,10,0.4905660377,0.641509434,0.5,0.5849056604,10,10,10,10,0,0,0,0,2,1,1,42,53,42,53,11,1
14,31,18,18,0.8888888889,1,0,18,0.982300885,1,0.8333333333,0.9734513274,18,18,18,18,0,0,0,0,2,1,1,113,113,113,113,0,1
52,61,10,10,0.9,0.9,0,10,0.9841269841,0.9841269841,0.9,0.9841269841,10,10,10,10,0,0,0,0,2,1,1,62,63,62,63,1,1
97,102,6,6,1,1,0,6,1,1,1,1,6,6,6,6,0,0,0,0,2,1,1,70,70,70,70,0,1
75,86,12,12,0.75,0.8333333333,0,12,0.9159663866,0.9579831933,0.75,0.9579831933,12,12,12,12,0,0,0,0,2,1,1,119,119,119,119,0,1
964,975,12,14,0.5714285714,0.7857142857,2,13,0.8017241379,0.8620689655,0.7142857143,0.8275862069,14,12,12,14,2,0,0,0,2,1,1,116,101,101,116,15,1
100,116,17,17,0.5263157895,0.8947368421,0,17,0.8901734104,0.9421965318,0.7894736842,0.9306358382,19,19,19,19,0,1,1,2,2,1,1,173,165,165,173,8,1
61,66,6,6,1,1,0,6,1,1,1,1,6,6,6,6,0,1,1,2,2,1,1,70,70,70,70,0,1
183,197,15,15,1,1,0,15,1,1,1,1,16,16,16,16,0,0,0,0,2,1,1,119,119,119,119,0,1
58,69,12,13,0.0769230769,0.0769230769,1,12.5,0.3257575758,0.5984848485,0.0769230769,0.4015151515,13,12,12,13,1,0,0,0,2,1,1,132,115,115,132,17,0
339,351,13,13,1,1,0,13,1,1,1,1,14,14,14,14,0,1,1,2,2,1,1,118,118,118,118,0,1
705,715,7,11,0.3,0.3,4,9,0.8333333333,0.8611111111,0.3,0.8611111111,6,10,6,10,4,1,1,2,4,2,2,62,72,62,72,10,0
472,493,22,22,0.9545454545,0.9545454545,0,22,0.9174311927,0.9357798165,0.5454545455,0.752293578,22,22,22,22,0,1,1,2,2,1,1,102,109,102,109,7,1
220,231,12,12,0.5833333333,0.9166666667,0,12,0.8559322034,0.9152542373,0.3333333333,0.7542372881,12,12,12,12,0,0,0,0,2,1,1,112,118,112,118,6,1
387,416,30,30,1,1,0,30,1,1,1,1,30,30,30,30,0,0,0,0,2,1,1,210,210,210,210,0,0
73,85,13,13,1,1,0,13,1,1,1,1,14,14,14,14,0,0,0,0,2,1,1,160,160,160,160,0,1
381,392,12,12,1,1,0,12,1,1,1,1,14,14,14,14,0,0,0,0,2,1,1,124,124,124,124,0,1
264,328,63,65,0.9259259259,1,2,64,0.9813829787,1,1,1,54,54,54,54,0,3,3,6,4,2,2,376,376,376,376,0,1
183,197,15,15,1,1,0,15,1,1,1,1,16,16,16,16,0,0,0,0,2,1,1,119,119,119,119,0,1
560,571,12,12,0.5833333333,0.9166666667,0,12,0.8559322034,0.9406779661,0.3333333333,0.7542372881,12,12,12,12,0,0,0,0,2,1,1,118,114,114,118,4,1
237,243,7,7,1,1,0,7,1,1,1,1,7,7,7,7,0,2,2,4,2,1,1,41,41,41,41,0,1
631,648,18,23,0.68,0.72,5,20.5,0.7165775401,0.7326203209,0.32,0.5989304813,25,20,20,25,5,0,0,0,2,1,1,187,137,137,187,50,1
126,138,13,13,1,1,0,13,1,1,1,1,13,13,13,13,0,0,0,0,2,1,1,111,111,111,111,0,1
595,605,11,11,1,1,0,11,1,1,1,1,13,13,13,13,0,0,0,0,2,1,1,99,99,99,99,0,1
102,110,9,9,0.8888888889,0.8888888889,0,9,0.9743589744,0.9743589744,0.8888888889,0.9743589744,9,9,9,9,0,0,0,0,2,1,1,76,78,76,78,2,1
541,563,23,23,1,1,0,23,1,1,1,1,25,25,25,25,0,0,0,0,2,1,1,187,187,187,187,0,1
47,61,15,15,0.9375,0.9375,0,15,0.9758064516,0.9758064516,0.1875,0.75,16,16,16,16,0,0,0,0,2,1,1,124,121,121,124,3,1
213,237,25,25,0.9230769231,0.9230769231,0,25,0.8452380952,0.8571428571,0.2692307692,0.6111111111,26,26,26,26,0,1,1,2,2,1,1,216,252,216,252,36,1
71,92,22,22,0.9583333333,1,0,22,0.9948979592,1,1,1,24,24,24,24,0,2,2,4,2,1,1,196,196,196,196,0,1
300,306,7,7,0.4285714286,0.7142857143,0,7,0.4473684211,0.5789473684,0.4285714286,0.5263157895,7,7,7,7,0,0,0,0,2,1,1,27,38,27,38,11,0
115,121,7,7,0.625,1,0,7,0.9473684211,1,1,1,8,8,8,8,0,1,1,2,2,1,1,76,76,76,76,0,1
51,81,31,36,0.8,0.8571428571,5,33.5,0.832460733,0.8429319372,0.6285714286,0.7958115183,35,31,31,35,4,0,0,0,2,1,1,191,162,162,191,29,1
166,176,11,11,0.3,0.3,0,11,0.3880597015,0.6268656716,0.3,0.447761194,10,10,10,10,0,0,0,0,4,2,2,67,63,63,67,4,0
640,653,11,14,0.4285714286,0.7857142857,3,12.5,0.6802721088,0.7142857143,0.7857142857,0.7142857143,11,14,11,14,3,0,0,0,2,1,1,105,147,105,147,42,1
147,165,19,19,0.9473684211,0.9473684211,0,19,0.9739130435,0.9826086957,0.9473684211,0.9826086957,19,19,19,19,0,0,0,0,2,1,1,114,115,114,115,1,1
26,41,14,16,0.1875,0.25,2,15,0.5315315315,0.7747747748,0.1875,0.5405405405,14,16,14,16,2,0,0,0,2,1,1,110,111,110,111,1,0
680,690,9,11,0.6153846154,0.7692307692,2,10,0.7171717172,0.7474747475,0.3846153846,0.5757575758,11,13,11,13,2,0,0,0,2,1,1,75,99,75,99,24,1
1877,1883,7,7,1,1,0,7,1,1,1,1,7,7,7,7,0,0,0,0,2,1,1,49,49,49,49,0,1
449,472,24,24,1,1,0,24,1,1,1,1,24,24,24,24,0,0,0,0,2,1,1,168,168,168,168,0,0
47,66,20,20,0.8,1,0,20,0.9757575758,1,1,1,20,20,20,20,0,0,0,0,2,1,1,165,165,165,165,0,1
31,31,1,1,0,0,0,1,0.8121212121,0.996969697,0,0.996969697,1,1,1,1,0,0,0,0,0,0,0,330,330,330,330,0,0
244,572,329,361,0.9702380952,0.9732142857,32,345,0.9974074074,0.9977777778,0.9732142857,0.9977777778,336,330,330,336,6,1,1,2,2,1,1,2700,2694,2694,2700,6,0
317,326,10,15,0.0666666667,0.2,5,12.5,0.3305084746,0.5084745763,0.1333333333,0.3983050847,15,10,10,15,5,0,0,0,2,1,1,118,70,70,118,48,0
175,197,23,23,1,1,0,23,1,1,1,1,23,23,23,23,0,3,3,6,2,1,1,108,108,108,108,0,1
53,65,13,13,0.8461538462,0.8461538462,0,13,0.8333333333,0.8541666667,0.2307692308,0.5833333333,13,13,13,13,0,0,0,0,2,1,1,83,96,83,96,13,1
993,1025,33,37,0.1538461538,0.1794871795,4,35,0.4322580645,0.6741935484,0.1538461538,0.4548387097,39,33,33,39,6,0,0,0,2,1,1,301,310,301,310,9,0
884,896,12,13,0.3846153846,0.5384615385,1,12.5,0.5,0.7083333333,0.3846153846,0.6111111111,12,13,12,13,1,0,0,0,2,1,1,65,72,65,72,7,0
43,52,10,10,1,1,0,10,1,1,1,1,10,10,10,10,0,0,0,0,2,1,1,88,88,88,88,0,1
104,110,7,7,0.7142857143,0.8571428571,0,7,0.84,0.92,0.8571428571,0.92,7,7,7,7,0,0,0,0,2,1,1,25,25,25,25,0,0
541,563,19,23,0.68,0.72,4,21,0.7326203209,0.7754010695,0.32,0.6256684492,21,25,21,25,4,0,0,0,2,1,1,149,187,149,187,38,0
316,327,12,12,0.5,0.8333333333,0,12,0.8684210526,0.9868421053,0.8333333333,0.9868421053,12,12,12,12,0,0,0,0,2,1,1,76,76,76,76,0,1
442,454,10,13,0.2307692308,0.3076923077,3,11.5,0.3536585366,0.5,0.2307692308,0.3780487805,10,13,10,13,3,0,0,0,2,1,1,57,82,57,82,25,0
968,985,18,18,0.6666666667,0.8333333333,0,18,0.8378378378,0.8918918919,0.2222222222,0.6576576577,18,18,18,18,0,0,0,0,2,1,1,102,111,102,111,9,1
586,603,18,18,0.8235294118,0.9411764706,0,18,0.8647058824,0.8823529412,0.3529411765,0.6352941176,17,17,17,17,0,1,1,2,4,2,2,170,151,151,170,19,1
188,251,61,64,0.9090909091,0.9090909091,3,62.5,0.9601226994,0.963190184,0.6515151515,0.9018404908,63,66,63,66,3,0,0,0,2,1,1,634,652,634,652,18,1
625,635,9,11,0.6153846154,0.8461538462,2,10,0.7272727273,0.7575757576,0.3846153846,0.5858585859,11,13,11,13,2,0,0,0,2,1,1,75,99,75,99,24,1
253,316,57,64,0.6071428571,0.625,7,60.5,0.7900262467,0.7926509186,0.1071428571,0.6010498688,50,56,50,56,6,1,1,2,2,1,1,303,381,303,381,78,1
561,568,8,8,0.8888888889,1,0,8,0.9807692308,1,1,1,9,9,9,9,0,1,1,2,2,1,1,52,52,52,52,0,1
24,55,31,32,0.78125,0.84375,1,31.5,0.9090909091,0.9409090909,0.15625,0.6772727273,31,32,31,32,1,0,0,0,2,1,1,220,216,216,220,4,1
10,10,1,26,0.0454545455,0.0454545455,25,13.5,0.9467749211,0.9467749211,0.0454545455,0.9467749211,22,1,1,22,21,0,0,0,1,1,0,2217,2099,2099,2217,118,0
9,100,92,92,1,1,0,92,1,1,1,1,81,81,81,81,0,2,2,4,2,1,1,655,655,655,655,0,1
447,509,63,63,1,1,0,63,1,1,1,1,63,63,63,63,0,0,0,0,2,1,1,455,455,455,455,0,1
870,896,27,27,1,1,0,27,1,1,1,1,27,27,27,27,0,0,0,0,2,1,1,193,193,193,193,0,1
835,852,18,18,1,1,0,18,1,1,1,1,19,19,19,19,0,0,0,0,2,1,1,169,169,169,169,0,1
907,922,16,16,0.8235294118,0.8235294118,0,16,0.897810219,0.9197080292,0.2352941176,0.7226277372,17,17,17,17,0,0,0,0,2,1,1,126,137,126,137,11,1
19,34,16,16,1,1,0,16,1,1,1,1,16,16,16,16,0,0,0,0,2,1,1,119,119,119,119,0,1
105,125,21,21,1,1,0,21,1,1,1,1,21,21,21,21,0,0,0,0,2,1,1,130,130,130,130,0,1
216,230,12,15,0.8,0.8,3,13.5,0.8656716418,0.8656716418,0.7333333333,0.8507462687,12,15,12,15,3,0,0,0,2,1,1,58,67,58,67,9,1
254,264,11,11,0.9090909091,1,0,11,0.9824561404,1,1,1,11,11,11,11,0,0,0,0,2,1,1,57,57,57,57,0,1
450,492,43,43,1,1,0,43,1,1,1,1,46,46,46,46,0,0,0,0,2,1,1,314,314,314,314,0,1
76,97,22,22,0.8,1,0,22,0.976744186,1,1,1,25,25,25,25,0,1,1,2,2,1,1,215,215,215,215,0,1
202,265,64,64,1,1,0,64,1,1,1,1,64,64,64,64,0,0,0,0,2,1,1,511,511,511,511,0,1
90,127,38,38,0.9736842105,0.9736842105,0,38,0.9921568627,0.9921568627,0.9736842105,0.9921568627,38,38,38,38,0,1,2,3,2,1,1,253,255,253,255,2,1
553,563,10,11,0.5384615385,0.7692307692,1,10.5,0.7070707071,0.8080808081,0.3076923077,0.6363636364,12,13,12,13,1,0,0,0,2,1,1,86,99,86,99,13,0
1089,1112,24,24,1,1,0,24,1,1,1,1,17,17,17,17,0,2,2,4,4,2,2,112,112,112,112,0,1
4,17,14,14,1,1,0,14,1,1,1,1,13,13,13,13,0,2,2,4,2,1,1,141,141,141,141,0,1
522,540,19,19,1,1,0,19,1,1,1,1,20,20,20,20,0,0,0,0,2,1,1,235,235,235,235,0,1
1011,1020,10,10,1,1,0,10,1,1,1,1,12,12,12,12,0,0,0,0,2,1,1,86,86,86,86,0,1
589,603,15,15,1,1,0,15,1,1,1,1,15,15,15,15,0,0,0,0,2,1,1,147,147,147,147,0,1
266,272,7,7,0.2857142857,0.7142857143,0,7,0.5675675676,0.8108108108,0.2857142857,0.5945945946,7,7,7,7,0,0,0,0,2,1,1,37,31,31,37,6,0
286,320,35,35,1,1,0,35,1,1,1,1,35,35,35,35,0,0,0,0,2,1,1,304,304,304,304,0,1
183,197,15,15,1,1,0,15,1,1,1,1,16,16,16,16,0,0,0,0,2,1,1,119,119,119,119,0,1
242,257,14,16,0.875,0.875,2,15,0.8134328358,0.8134328358,0.875,0.8134328358,14,16,14,16,2,0,0,0,2,1,1,109,134,109,134,25,1
898,908,11,11,1,1,0,11,1,1,1,1,11,11,11,11,0,1,1,2,2,1,1,75,75,75,75,0,1
292,322,31,31,1,1,0,31,1,1,1,1,31,31,31,31,0,0,0,0,2,1,1,217,217,217,217,0,1
588,604,17,17,1,1,0,17,1,1,1,1,17,17,17,17,0,2,2,4,2,1,1,306,306,306,306,0,1
265,273,9,9,0.6363636364,0.7272727273,0,9,0.7066666667,0.7733333333,0.3636363636,0.64,11,11,11,11,0,0,0,0,2,1,1,75,74,74,75,1,1
9,20,12,12,0.9285714286,0.9285714286,0,12,0.992481203,0.992481203,0.9285714286,0.992481203,14,14,14,14,0,0,0,0,2,1,1,133,133,133,133,0,1
1,588,588,588,1,1,0,588,1,1,1,1,531,531,531,531,0,0,0,0,0,0,0,4856,4856,4856,4856,0,1
183,197,15,15,1,1,0,15,1,1,1,1,16,16,16,16,0,0,0,0,2,1,1,119,119,119,119,0,1
38,40,3,3,0,1,0,3,0.8333333333,1,0.6666666667,0.9666666667,3,3,3,3,0,0,0,0,2,1,1,60,60,60,60,0,1
1752,1766,15,15,1,1,0,15,1,1,1,1,15,15,15,15,0,1,1,2,2,1,1,99,99,99,99,0,0
574,584,11,18,0.1052631579,0.2105263158,7,14.5,0.375,0.5666666667,0.1052631579,0.4,19,11,11,19,8,0,0,0,2,1,1,120,94,94,120,26,0
128,154,22,27,0.1851851852,0.2222222222,5,24.5,0.3191489362,0.5053191489,0.1851851852,0.335106383,23,27,23,27,4,0,0,0,2,1,1,147,188,147,188,41,0
390,398,9,9,0.7777777778,0.8888888889,0,9,0.8783783784,0.9459459459,0.8888888889,0.9324324324,9,9,9,9,0,1,1,2,2,1,1,74,70,70,74,4,1
164,172,9,9,0.7,1,0,9,0.9655172414,1,1,1,10,10,10,10,0,1,1,2,2,1,1,87,87,87,87,0,1
84,96,13,13,0.3076923077,0.3076923077,0,13,0.3452380952,0.6071428571,0.3076923077,0.4642857143,13,13,13,13,0,0,0,0,2,1,1,74,84,74,84,10,0
1342,1358,17,18,0.6666666667,0.8888888889,1,17.5,0.8707482993,0.9455782313,0.8333333333,0.9183673469,18,18,18,18,0,0,1,1,2,1,1,146,147,146,147,1,1
10,10,1,42,0.0357142857,0.0357142857,41,21.5,0.9316466933,0.9316466933,0.0357142857,0.9316466933,28,1,1,28,27,1,0,1,0,0,0,2253,2099,2099,2253,154,0
47,63,17,17,0.1764705882,1,0,17,0.8131868132,1,1,1,17,17,17,17,0,0,0,0,2,1,1,91,91,91,91,0,0
17,30,10,14,0.6666666667,0.6666666667,4,12,0.968,0.968,0.6666666667,0.968,12,15,12,15,3,0,0,0,2,1,1,121,125,121,125,4,1
144,160,17,17,0.7368421053,1,0,17,0.9712643678,1,1,1,19,19,19,19,0,1,1,2,2,1,1,174,174,174,174,0,1
418,427,10,10,0.6666666667,0.9166666667,0,10,0.8705882353,0.9647058824,0.4166666667,0.7294117647,12,12,12,12,0,0,0,0,2,1,1,85,82,82,85,3,1
332,341,10,10,1,1,0,10,1,1,1,1,10,10,10,10,0,0,0,0,2,1,1,119,119,119,119,0,1
129,148,20,20,1,1,0,20,1,1,1,1,23,23,23,23,0,0,0,0,2,1,1,198,198,198,198,0,1
753,761,9,9,0.4444444444,1,0,9,0.8305084746,1,1,1,9,9,9,9,0,1,1,2,2,1,1,59,59,59,59,0,0
80,117,38,38,0.7777777778,1,0,38,0.9529411765,1,1,1,18,18,18,18,0,1,1,2,4,2,2,85,85,85,85,0,1
667,685,18,19,0.8571428571,0.9047619048,1,18.5,0.8724832215,0.8926174497,0.7142857143,0.8187919463,20,21,20,21,1,0,0,0,2,1,1,137,149,137,149,12,1
406,441,36,36,1,1,0,36,1,1,1,1,38,38,38,38,0,0,0,0,2,1,1,349,349,349,349,0,1
168,186,19,21,0.1818181818,0.2272727273,2,20,0.3607594937,0.5949367089,0.1818181818,0.3987341772,22,20,20,22,2,0,0,0,3,1,2,156,158,156,158,2,0
667,685,19,21,0.7391304348,0.7826086957,2,20,0.8192771084,0.8614457831,0.347826087,0.6987951807,23,21,21,23,2,0,0,0,2,1,1,166,149,149,166,17,1
521,529,9,9,0.8181818182,0.9090909091,0,9,0.92,0.96,0.9090909091,0.96,11,11,11,11,0,0,0,0,2,1,1,75,75,75,75,0,1
3,81,79,79,1,1,0,79,1,1,1,1,20,20,20,20,0,1,1,2,0,0,0,2087,2087,2087,2087,0,1
50,68,13,19,0.3684210526,0.4736842105,6,16,0.8828828829,0.9279279279,0.2105263158,0.6846846847,13,19,13,19,6,0,0,0,2,1,1,111,109,109,111,2,1
90,172,83,83,1,1,0,83,1,1,1,1,83,83,83,83,0,0,0,0,2,1,1,756,756,756,756,0,1
314,326,13,15,0.4666666667,0.5333333333,2,14,0.7551020408,0.8639455782,0.4666666667,0.7823129252,15,13,13,15,2,0,0,0,2,1,1,147,144,144,147,3,0
351,372,22,22,1,1,0,22,1,1,1,1,22,22,22,22,0,0,0,0,2,1,1,287,287,287,287,0,1
100,105,6,6,0.5714285714,0.8571428571,0,6,0.9322033898,0.9661016949,0.8571428571,0.9661016949,7,7,7,7,0,1,1,2,2,1,1,59,59,59,59,0,1
642,652,11,11,1,1,0,11,1,1,1,1,11,11,11,11,0,1,1,2,2,1,1,102,102,102,102,0,1
783,795,13,13,0.9285714286,1,0,13,0.9913793103,1,1,1,14,14,14,14,0,1,1,2,2,1,1,116,116,116,116,0,1
462,471,10,14,0.2,0.3333333333,4,12,0.4695652174,0.6869565217,0.1333333333,0.4956521739,15,12,12,15,3,0,0,0,2,1,1,115,103,103,115,12,0
648,665,18,21,0.7391304348,0.7826086957,3,19.5,0.7951807229,0.813253012,0.347826087,0.656626506,23,20,20,23,3,0,0,0,2,1,1,166,137,137,166,29,1
790,801,11,12,0.5,0.8333333333,1,11.5,0.8347826087,0.9130434783,0.3333333333,0.747826087,11,12,11,12,1,0,0,0,2,1,1,105,115,105,115,10,1
443,485,43,43,1,1,0,43,1,1,1,1,46,46,46,46,0,0,0,0,2,1,1,314,314,314,314,0,1
40,72,33,33,1,1,0,33,1,1,1,1,41,41,41,41,0,1,1,2,2,1,1,399,399,399,399,0,1
922,975,54,54,1,1,0,54,1,1,1,1,58,58,58,58,0,0,0,0,2,1,1,508,508,508,508,0,1
496,504,9,9,1,1,0,9,1,1,1,1,9,9,9,9,0,1,1,2,2,1,1,110,110,110,110,0,1
317,334,18,18,0.3529411765,1,0,18,0.8764044944,1,0.9411764706,0.9943820225,17,17,17,17,0,0,0,0,4,2,2,178,178,178,178,0,1
1019,1033,15,16,0.375,0.75,1,15.5,0.5789473684,0.7280701754,0.5625,0.5701754386,16,15,15,16,1,0,0,0,2,1,1,114,94,94,114,20,1
442,472,31,31,1,1,0,31,1,1,1,1,31,31,31,31,0,0,0,0,2,1,1,217,217,217,217,0,1
13,32,18,20,0.8,0.9,2,19,0.874015748,0.8897637795,0.9,0.8897637795,18,20,18,20,2,0,0,0,2,1,1,113,127,113,127,14,1
148,165,18,18,0.8888888889,1,0,18,0.9891304348,1,1,1,18,18,18,18,0,0,0,0,2,1,1,184,184,184,184,0,1
50,61,12,12,1,1,0,12,1,1,1,1,12,12,12,12,0,0,0,0,2,1,1,83,83,83,83,0,1
74,85,12,14,0.5,0.7142857143,2,13,0.6586826347,0.7125748503,0.5,0.6347305389,14,12,12,14,2,0,0,0,2,1,1,167,119,119,167,48,1
110,121,12,12,1,1,0,12,1,1,1,1,12,12,12,12,0,0,0,0,2,1,1,92,92,92,92,0,1
15,25,11,11,1,1,0,11,1,1,1,1,11,11,11,11,0,0,0,0,2,1,1,65,65,65,65,0,1
538,547,10,10,1,1,0,10,1,1,1,1,10,10,10,10,0,1,1,2,2,1,1,177,177,177,177,0,1
750,759,10,10,1,1,0,10,1,1,1,1,10,10,10,10,0,1,1,2,2,1,1,113,113,113,113,0,1
794,803,10,10,0.8,0.8,0,10,0.9824561404,0.9824561404,0.8,0.9824561404,10,10,10,10,0,1,1,2,2,1,1,114,112,112,114,2,1
337,355,19,26,0.1923076923,0.3076923077,7,22.5,0.3561643836,0.5547945205,0.1923076923,0.3904109589,26,19,19,26,7,0,0,0,2,1,1,146,116,116,146,30,0
355,365,11,11,0.5384615385,0.5384615385,0,11,0.7684210526,0.8105263158,0.3846153846,0.6315789474,13,13,13,13,0,0,0,0,2,1,1,95,91,91,95,4,1
525,541,16,17,0.1111111111,0.1111111111,1,16.5,0.3174603175,0.5238095238,0.1111111111,0.4444444444,8,9,8,9,1,0,0,0,4,2,2,59,63,59,63,4,0
193,214,22,22,1,1,0,22,1,1,1,1,22,22,22,22,0,1,1,2,2,1,1,239,239,239,239,0,1
602,673,19,72,0.0547945205,0.0547945205,53,45.5,0.0973154362,0.1493288591,0.0547945205,0.1157718121,19,73,19,73,54,0,0,0,2,1,1,103,596,103,596,493,0
454,467,14,14,1,1,0,14,1,1,1,1,14,14,14,14,0,0,0,0,2,1,1,128,128,128,128,0,1
362,393,30,32,0.9375,0.9375,2,31,0.959798995,0.959798995,0.34375,0.7135678392,30,32,30,32,2,0,0,0,2,1,1,382,398,382,398,16,1
138,143,6,6,0.7142857143,1,0,6,0.9275362319,1,1,1,7,7,7,7,0,1,1,2,2,1,1,69,69,69,69,0,1
847,880,27,34,0.5294117647,0.7352941176,7,30.5,0.7380952381,0.8,0.3235294118,0.6428571429,27,34,27,34,7,0,0,0,2,1,1,175,210,175,210,35,1
286,324,39,39,1,1,0,39,1,1,1,1,39,39,39,39,0,1,1,2,2,1,1,356,356,356,356,0,1
1292,1303,12,14,0.7333333333,0.7333333333,2,13,0.9519230769,0.9615384615,0.2,0.7307692308,15,13,13,15,2,4,2,6,2,1,1,104,103,103,104,1,1
902,911,10,10,0.7,1,0,10,0.9594594595,1,1,1,10,10,10,10,0,0,0,0,2,1,1,74,74,74,74,0,1
860,872,13,13,0.6923076923,0.7692307692,0,13,0.8888888889,0.9191919192,0.7692307692,0.9191919192,13,13,13,13,0,0,0,0,2,1,1,190,198,190,198,8,0
548,570,23,23,0.88,1,0,23,0.9786096257,1,1,1,25,25,25,25,0,0,0,0,2,1,1,187,187,187,187,0,1
402,425,24,24,1,1,0,24,1,1,1,1,24,24,24,24,0,0,0,0,2,1,1,168,168,168,168,0,0
117,127,11,14,0.2142857143,0.2857142857,3,12.5,0.3,0.4818181818,0.2142857143,0.3272727273,14,12,12,14,2,0,0,0,2,1,1,110,74,74,110,36,0
63,72,10,10,0.3,0.6,0,10,0.2988505747,0.4022988506,0.3,0.3103448276,10,10,10,10,0,0,0,0,2,1,1,87,39,39,87,48,0
539,548,10,10,0.3,0.7,0,10,0.4193548387,0.5806451613,0.4,0.4677419355,10,10,10,10,0,0,0,0,2,1,1,43,62,43,62,19,0
64,66,3,3,0,0.6666666667,0,3,0.75,0.9230769231,0.6666666667,0.9038461538,3,3,3,3,0,0,0,0,2,1,1,48,52,48,52,4,0
497,516,20,20,0.9523809524,0.9523809524,0,20,0.9912280702,0.9912280702,0.9523809524,0.9912280702,21,21,21,21,0,0,0,0,2,1,1,114,114,114,114,0,1
147,262,116,116,0.9569892473,1,0,116,0.9894736842,1,1,1,93,93,93,93,0,1,1,2,4,2,2,665,665,665,665,0,0
158,172,15,15,0.6666666667,0.9333333333,0,15,0.9160839161,0.958041958,0.9333333333,0.9440559441,15,15,15,15,0,1,1,2,2,1,1,139,143,139,143,4,0
276,279,4,4,0.25,1,0,4,0.9482758621,1,1,1,4,4,4,4,0,1,1,2,2,1,1,58,58,58,58,0,1
130,136,7,8,0.5,0.625,1,7.5,0.5217391304,0.5869565217,0.5,0.5434782609,8,7,7,8,1,0,0,0,2,1,1,43,46,43,46,3,0
199,217,19,19,0.75,1,0,19,0.9104477612,1,0.9,0.9552238806,20,20,20,20,0,0,0,0,2,1,1,134,134,134,134,0,1
55,58,4,4,0,0,0,4,0.8066037736,0.8867924528,0,0.8349056604,4,4,4,4,0,0,0,0,2,1,1,212,188,188,212,24,0
851,865,15,17,0.45,0.8,2,16,0.8146341463,0.8780487805,0.15,0.6585365854,20,18,18,20,2,0,0,0,2,1,1,205,195,195,205,10,0
594,604,11,11,1,1,0,11,1,1,1,1,12,12,12,12,0,0,0,0,2,1,1,76,76,76,76,0,1
367,379,13,13,1,1,0,13,1,1,1,1,13,13,13,13,0,0,0,0,2,1,1,124,124,124,124,0,1
184,193,10,10,0.9,1,0,10,0.9677419355,1,1,1,10,10,10,10,0,0,0,0,2,1,1,62,62,62,62,0,1
656,667,12,13,0.5384615385,0.8461538462,1,12.5,0.8606557377,0.9344262295,0.3846153846,0.7950819672,13,12,12,13,1,0,0,0,2,1,1,122,114,114,122,8,1
367,379,13,13,1,1,0,13,1,1,1,1,13,13,13,13,0,0,0,0,2,1,1,124,124,124,124,0,1
639,653,12,15,0.4666666667,0.8,3,13.5,0.6845637584,0.7181208054,0.8,0.7181208054,12,15,12,15,3,0,0,0,2,1,1,107,149,107,149,42,0
10,1556,1,1547,0.0357142857,0.0357142857,1546,774,0.9316466933,0.9316466933,0.0357142857,0.9316466933,1,28,1,28,27,0,1,1,0,0,0,2099,2253,2099,2253,154,0
194,214,18,21,0.1904761905,0.2380952381,3,19.5,0.3941605839,0.598540146,0.1904761905,0.4452554745,20,21,20,21,1,0,0,0,2,1,1,137,117,117,137,20,0
381,388,7,8,0.375,0.625,1,7.5,0.625,0.84375,0.5,0.71875,7,8,7,8,1,0,0,0,2,1,1,31,32,31,32,1,0
59,77,19,19,0.9473684211,0.9473684211,0,19,0.9593023256,0.9651162791,0.9473684211,0.9593023256,19,19,19,19,0,0,0,0,2,1,1,166,172,166,172,6,1
99,109,11,11,1,1,0,11,1,1,1,1,11,11,11,11,0,0,0,0,2,1,1,55,55,55,55,0,1
209,258,50,50,0.9607843137,0.9607843137,0,50,0.9662650602,0.9734939759,0.1176470588,0.6819277108,51,51,51,51,0,2,2,4,4,2,2,409,415,409,415,6,0
553,559,7,22,0,0.0909090909,15,14.5,0.3714285714,0.6285714286,0,0.4285714286,11,7,7,11,4,1,0,1,3,2,1,70,61,61,70,9,0
183,197,15,15,1,1,0,15,1,1,1,1,16,16,16,16,0,0,0,0,2,1,1,119,119,119,119,0,1
490,499,10,10,0.5833333333,0.8333333333,0,10,0.8023255814,0.8953488372,0.4166666667,0.8023255814,12,12,12,12,0,0,0,0,2,1,1,86,83,83,86,3,1
249,257,9,9,0.6363636364,0.7272727273,0,9,0.8461538462,0.8974358974,0.7272727273,0.8974358974,11,11,11,11,0,0,0,0,2,1,1,74,78,74,78,4,0
522,544,23,23,1,1,0,23,1,1,1,1,25,25,25,25,0,0,0,0,2,1,1,187,187,187,187,0,1
445,453,9,9,0.9090909091,1,0,9,0.976744186,1,1,1,11,11,11,11,0,0,0,0,2,1,1,86,86,86,86,0,1
81,92,12,12,0.9230769231,1,0,12,0.9902912621,1,1,1,13,13,13,13,0,1,1,2,2,1,1,103,103,103,103,0,1
570,590,19,21,0.7391304348,0.7826086957,2,20,0.8192771084,0.8614457831,0.347826087,0.6987951807,21,23,21,23,2,0,0,0,2,1,1,149,166,149,166,17,1
156,170,15,17,0.1176470588,0.1764705882,2,16,0.3538461538,0.5923076923,0.1176470588,0.4230769231,17,15,15,17,2,0,0,0,2,1,1,130,125,125,130,5,0
53,166,114,114,0.9579831933,0.9579831933,0,114,0.9953746531,0.9953746531,0.9579831933,0.9953746531,119,119,119,119,0,0,0,0,2,1,1,1076,1081,1076,1081,5,1
38,40,3,3,0,1,0,3,0.8846153846,1,1,1,3,3,3,3,0,0,0,0,2,1,1,52,52,52,52,0,0
394,404,11,15,0.4375,0.5,4,13,0.8034682081,0.8554913295,0.125,0.6589595376,16,12,12,16,4,0,0,0,2,1,1,173,159,159,173,14,1
15,32,18,24,0.5833333333,0.75,6,21,0.7077922078,0.7337662338,0.6666666667,0.7207792208,24,18,18,24,6,0,0,0,2,1,1,154,113,113,154,41,1
439,468,30,30,1,1,0,30,1,1,1,1,30,30,30,30,0,0,0,0,2,1,1,210,210,210,210,0,0
17,25,9,9,1,1,0,9,1,1,1,1,9,9,9,9,0,1,1,2,2,1,1,56,56,56,56,0,1
453,463,11,11,0.5384615385,0.5384615385,0,11,0.7684210526,0.8105263158,0.3846153846,0.6315789474,13,13,13,13,0,0,0,0,2,1,1,91,95,91,95,4,1
131,137,7,7,0.625,1,0,7,0.9473684211,1,1,1,8,8,8,8,0,1,1,2,2,1,1,76,76,76,76,0,0
28,39,11,12,0.1666666667,0.1666666667,1,11.5,0.6043956044,0.7032967033,0.1666666667,0.7032967033,11,12,11,12,1,0,0,0,2,1,1,79,91,79,91,12,0
1561,1566,6,6,0.8,1,0,6,0.9791666667,1,1,1,5,5,5,5,0,1,1,2,2,1,1,48,48,48,48,0,1
360,385,26,32,0.0666666667,0.2,6,29,0.3990825688,0.6513761468,0.0666666667,0.4220183486,30,26,26,30,4,0,0,0,3,1,2,218,218,218,218,0,1
386,411,26,26,1,1,0,26,1,1,1,1,26,26,26,26,0,0,0,0,2,1,1,182,182,182,182,0,1
608,614,7,8,0.25,0.75,1,7.5,0.5178571429,0.7142857143,0.625,0.6964285714,8,7,7,8,1,0,0,0,2,1,1,56,40,40,56,16,0
55,69,15,15,1,1,0,15,1,1,1,1,17,17,17,17,0,0,0,0,4,2,2,104,104,104,104,0,1
57,59,3,3,0,0.6666666667,0,3,0.75,0.9230769231,0.6666666667,0.9038461538,3,3,3,3,0,0,0,0,2,1,1,48,52,48,52,4,1
131,166,32,36,0.5945945946,0.6216216216,4,34,0.8116591928,0.8251121076,0.2432432432,0.5896860987,33,37,33,37,4,0,0,0,2,1,1,391,446,391,446,55,1
733,749,17,17,0.8235294118,0.8823529412,0,17,0.9029126214,0.9417475728,0.7058823529,0.8834951456,17,17,17,17,0,0,0,0,2,1,1,103,100,100,103,3,1
180,188,9,9,0.7,1,0,9,0.9655172414,1,1,1,10,10,10,10,0,1,1,2,2,1,1,87,87,87,87,0,0
206,217,12,16,0.7058823529,0.7058823529,4,14,0.9708029197,0.9708029197,0.7058823529,0.9708029197,17,14,14,17,3,0,0,0,2,1,1,137,133,133,137,4,1
43,54,11,12,0.25,0.25,1,11.5,0.3333333333,0.5256410256,0.25,0.3974358974,11,12,11,12,1,0,0,0,2,1,1,67,78,67,78,11,1
110,121,12,14,0.5,0.5,2,13,0.8333333333,0.86,0,0.6066666667,14,12,12,14,2,1,1,2,2,1,1,141,150,141,150,9,1
120,136,17,17,0.5263157895,0.8947368421,0,17,0.8516483516,0.9120879121,0.4736842105,0.7142857143,19,19,19,19,0,1,1,2,2,1,1,166,182,166,182,16,0
340,343,4,4,1,1,0,4,1,1,1,1,5,5,5,5,0,0,0,0,2,1,1,57,57,57,57,0,1
321,330,10,10,0.3,0.7,0,10,0.4923076923,0.6923076923,0.4,0.5846153846,10,10,10,10,0,0,0,0,2,1,1,52,65,52,65,13,0
225,241,17,17,1,1,0,17,1,1,1,1,19,19,19,19,0,0,0,0,2,1,1,185,185,185,185,0,1
231,248,18,18,1,1,0,18,1,1,1,1,18,18,18,18,0,2,2,4,2,1,1,117,117,117,117,0,1
306,336,31,31,1,1,0,31,1,1,1,1,31,31,31,31,0,0,0,0,2,1,1,217,217,217,217,0,0
545,554,10,10,0.3,0.3,0,10,0.3857142857,0.6,0.3,0.4571428571,10,10,10,10,0,0,0,0,3,1,2,70,55,55,70,15,0
17,535,519,519,1,1,0,519,1,1,1,1,353,353,353,353,0,0,0,0,0,0,0,2756,2756,2756,2756,0,1
492,751,260,260,0.995412844,0.995412844,0,260,0.9987325729,0.9987325729,0.995412844,0.9987325729,218,218,218,218,0,1,1,2,4,2,2,1578,1576,1576,1578,2,1
442,472,31,31,1,1,0,31,1,1,1,1,31,31,31,31,0,0,0,0,2,1,1,217,217,217,217,0,0
91,100,10,10,0.3,0.7,0,10,0.4615384615,0.6153846154,0.4,0.5,10,10,10,10,0,0,0,0,2,1,1,52,39,39,52,13,1
834,1228,395,395,1,1,0,395,1,1,1,1,248,248,248,248,0,1,1,2,2,1,1,1269,1269,1269,1269,0,1
76,108,33,33,0.8108108108,1,0,33,0.9780564263,1,1,1,37,37,37,37,0,1,1,2,2,1,1,319,319,319,319,0,0
656,667,12,15,0.4666666667,0.8,3,13.5,0.7032258065,0.735483871,0.5333333333,0.7225806452,15,12,12,15,3,0,0,0,2,1,1,155,114,114,155,41,1
43,71,29,29,1,1,0,29,1,1,1,1,29,29,29,29,0,0,0,0,2,1,1,240,240,240,240,0,1
216,229,14,14,1,1,0,14,1,1,1,1,14,14,14,14,0,0,0,0,2,1,1,107,107,107,107,0,1
52,106,55,55,1,1,0,55,1,1,1,1,28,28,28,28,0,1,1,2,0,0,0,241,241,241,241,0,1
260,268,9,9,0.6363636364,0.7272727273,0,9,0.7066666667,0.7733333333,0.3636363636,0.64,11,11,11,11,0,0,0,0,2,1,1,75,74,74,75,1,1
59,86,28,28,0.8387096774,1,0,28,0.9805447471,1,1,1,31,31,31,31,0,1,1,2,2,1,1,257,257,257,257,0,1
104,136,33,33,0.9705882353,0.9705882353,0,33,0.9963369963,0.9963369963,0.9705882353,0.9963369963,34,34,34,34,0,1,1,2,4,2,2,273,273,273,273,0,1
642,648,7,8,0,0.5,1,7.5,0.5081967213,0.6885245902,0,0.5245901639,8,7,7,8,1,1,0,1,2,1,1,57,61,57,61,4,0
147,163,17,17,0.962962963,0.962962963,0,17,0.9760956175,0.984063745,0.962962963,0.9800796813,27,27,27,27,0,0,0,0,2,1,1,247,251,247,251,4,1
185,554,370,378,0.9497487437,0.9497487437,8,374,0.9954441913,0.9954441913,0.9497487437,0.9954441913,199,193,193,199,6,3,3,6,4,2,2,1756,1748,1748,1756,8,1
272,278,7,7,0.7142857143,1,0,7,0.9821428571,1,1,1,7,7,7,7,0,1,1,2,2,1,1,112,112,112,112,0,1
394,404,11,11,1,1,0,11,1,1,1,1,12,12,12,12,0,0,0,0,2,1,1,159,159,159,159,0,1
596,670,59,75,0.7012987013,0.7012987013,16,67,0.9790301442,0.9790301442,0.7012987013,0.9790301442,61,77,61,77,16,1,1,2,2,1,1,759,763,759,763,4,1
113,124,12,12,1,1,0,12,1,1,1,1,12,12,12,12,0,0,0,0,2,1,1,67,67,67,67,0,1
470,500,31,31,1,1,0,31,1,1,1,1,31,31,31,31,0,0,0,0,2,1,1,217,217,217,217,0,0
490,499,10,11,0.7692307692,0.7692307692,1,10.5,0.8282828283,0.8383838384,0.2307692308,0.6262626263,13,12,12,13,1,0,0,0,2,1,1,99,83,83,99,16,1
153,188,36,36,1,1,0,36,1,1,1,1,37,37,37,37,0,0,0,0,2,1,1,244,244,244,244,0,1
588,597,10,13,0.0769230769,0.0769230769,3,11.5,0.3777777778,0.5888888889,0.0769230769,0.4888888889,13,10,10,13,3,0,0,0,2,1,1,90,68,68,90,22,0
358,365,8,8,1,1,0,8,1,1,1,1,8,8,8,8,0,0,0,0,2,1,1,51,51,51,51,0,1
460,489,30,30,1,1,0,30,1,1,1,1,30,30,30,30,0,0,0,0,2,1,1,210,210,210,210,0,0
611,619,9,11,0.6153846154,0.8461538462,2,10,0.7272727273,0.7575757576,0.3846153846,0.5858585859,13,11,11,13,2,0,0,0,2,1,1,99,75,75,99,24,1
159,166,8,8,1,1,0,8,1,1,1,1,8,8,8,8,0,1,1,2,2,1,1,98,98,98,98,0,1
189,199,11,13,0.6923076923,0.6923076923,2,12,0.9347826087,0.9456521739,0.6923076923,0.9456521739,13,11,11,13,2,1,1,2,4,2,2,89,92,89,92,3,1
1342,1358,17,18,0.6666666667,0.8888888889,1,17.5,0.8707482993,0.9455782313,0.8333333333,0.9183673469,18,18,18,18,0,0,1,1,2,1,1,146,147,146,147,1,1
51,63,13,13,0.9230769231,0.9230769231,0,13,0.8,0.82,0.8461538462,0.81,13,13,13,13,0,0,0,0,2,1,1,100,84,84,100,16,1
440,452,13,14,0.7142857143,0.7857142857,1,13.5,0.8796992481,0.9172932331,0.5714285714,0.7969924812,14,13,13,14,1,0,0,0,2,1,1,128,133,128,133,5,1
463,484,22,22,1,1,0,22,1,1,1,1,22,22,22,22,0,0,0,0,2,1,1,154,154,154,154,0,0
42,44,3,3,0,1,0,3,0.9,1,1,1,3,3,3,3,0,0,0,0,2,1,1,60,60,60,60,0,1
360,391,32,32,1,1,0,32,1,1,1,1,32,32,32,32,0,0,0,0,2,1,1,224,224,224,224,0,0
104,117,14,14,1,1,0,14,1,1,1,1,14,14,14,14,0,0,0,0,2,1,1,91,91,91,91,0,1
320,355,36,50,0.72,0.72,14,43,0.7819148936,0.7819148936,0.54,0.7446808511,50,36,36,50,14,0,0,0,2,1,1,376,294,294,376,82,0
402,432,31,31,1,1,0,31,1,1,1,1,31,31,31,31,0,0,0,0,2,1,1,217,217,217,217,0,0
623,633,10,11,0.3636363636,0.7272727273,1,10.5,0.5147058824,0.6470588235,0.3636363636,0.5588235294,10,11,10,11,1,0,0,0,2,1,1,50,68,50,68,18,0
306,331,26,26,0,0,0,26,0.1904761905,0.2857142857,0,0.2380952381,26,26,26,26,0,0,0,0,2,1,1,546,182,182,546,364,0
522,544,18,23,0.68,0.72,5,20.5,0.7165775401,0.7326203209,0.32,0.5989304813,20,25,20,25,5,0,0,0,2,1,1,137,187,137,187,50,1
228,261,34,34,1,1,0,34,1,1,1,1,34,34,34,34,0,1,1,2,4,2,2,311,311,311,311,0,1
128,144,17,17,0.6315789474,0.9473684211,0,17,0.9075144509,0.9537572254,0.8421052632,0.9421965318,19,19,19,19,0,1,1,2,2,1,1,165,173,165,173,8,1
648,665,18,21,0.7391304348,0.7826086957,3,19.5,0.7951807229,0.813253012,0.347826087,0.656626506,23,20,20,23,3,0,0,0,2,1,1,166,137,137,166,29,1
448,469,22,22,1,1,0,22,1,1,1,1,22,22,22,22,0,0,0,0,2,1,1,154,154,154,154,0,0
292,317,26,26,1,1,0,26,1,1,1,1,26,26,26,26,0,0,0,0,2,1,1,337,337,337,337,0,1
469,485,12,17,0.1176470588,0.1176470588,5,14.5,0.2857142857,0.5194805195,0.1176470588,0.3181818182,12,17,12,17,5,0,0,0,2,1,1,108,154,108,154,46,0
560,588,29,29,0.9642857143,0.9642857143,0,29,0.9923076923,0.9923076923,0.9642857143,0.9923076923,28,28,28,28,0,2,2,4,2,1,1,258,260,258,260,2,1
184,200,17,17,0.7368421053,1,0,17,0.9698795181,1,1,1,19,19,19,19,0,1,1,2,2,1,1,166,166,166,166,0,0
488,494,7,7,1,1,0,7,1,1,1,1,7,7,7,7,0,0,0,0,2,1,1,51,51,51,51,0,1
406,441,36,36,1,1,0,36,1,1,1,1,38,38,38,38,0,0,0,0,2,1,1,349,349,349,349,0,1
212,264,53,53,1,1,0,53,1,1,1,1,50,50,50,50,0,1,1,2,2,1,1,324,324,324,324,0,1
940,952,13,14,0.4285714286,0.7857142857,1,13.5,0.7103448276,0.8206896552,0.2857142857,0.6482758621,14,13,13,14,1,0,0,0,2,1,1,145,121,121,145,24,1
146,158,13,13,0.6923076923,0.9230769231,0,13,0.9044117647,0.9264705882,0.9230769231,0.9264705882,13,13,13,13,0,0,1,1,2,1,1,136,127,127,136,9,1
841,864,24,24,0.4166666667,0.6666666667,0,24,0.5189873418,0.6898734177,0.3333333333,0.4936708861,24,24,24,24,0,0,0,0,2,1,1,158,132,132,158,26,0
564,589,26,26,1,1,0,26,1,1,1,1,26,26,26,26,0,0,0,0,2,1,1,182,182,182,182,0,0
135,143,9,9,1,1,0,9,1,1,1,1,9,9,9,9,0,1,1,2,2,1,1,118,118,118,118,0,1
66,70,5,5,0,0.8,0,5,0.7,0.8,0.8,0.8,5,5,5,5,0,1,0,1,2,1,1,65,80,65,80,15,1
1401,1417,17,17,0.5882352941,0.8235294118,0,17,0.8300653595,0.908496732,0.3529411765,0.7712418301,17,17,17,17,0,0,0,0,2,1,1,142,153,142,153,11,1
572,592,21,23,0.84,0.88,2,22,0.8395721925,0.871657754,0.68,0.807486631,25,23,23,25,2,0,0,0,2,1,1,187,166,166,187,21,1
23,64,42,42,1,1,0,42,1,1,1,1,39,39,39,39,0,0,0,0,0,0,0,397,397,397,397,0,1
128,139,12,12,0.5833333333,0.75,0,12,0.7619047619,0.8095238095,0.5,0.7380952381,12,12,12,12,0,0,0,0,2,1,1,104,126,104,126,22,1
33,39,7,7,1,1,0,7,1,1,1,1,7,7,7,7,0,1,1,2,2,1,1,70,70,70,70,0,1
723,729,7,7,0.5714285714,0.7142857143,0,7,0.59375,0.65625,0.7142857143,0.65625,7,7,7,7,0,0,0,0,2,1,1,32,22,22,32,10,0
251,262,10,12,0.3846153846,0.4615384615,2,11,0.6761904762,0.7238095238,0.3076923077,0.6,12,13,12,13,1,0,0,0,2,1,1,105,98,98,105,7,0
459,472,13,14,0.7142857143,0.7857142857,1,13.5,0.8796992481,0.9172932331,0.5714285714,0.7969924812,13,14,13,14,1,0,0,0,2,1,1,133,128,128,133,5,0
369,379,11,13,0.5384615385,0.8461538462,2,12,0.7933884298,0.867768595,0.3076923077,0.7107438017,13,11,11,13,2,0,0,0,2,1,1,121,105,105,121,16,0
139,145,7,7,0.625,0.875,0,7,0.8421052632,0.8947368421,0.375,0.6578947368,8,8,8,8,0,1,1,2,2,1,1,68,76,68,76,8,1
498,504,7,7,0.5714285714,1,0,7,0.9436619718,1,1,1,7,7,7,7,0,1,1,2,2,1,1,71,71,71,71,0,1
63,82,20,20,0.1363636364,0.2272727273,0,20,0.2742857143,0.5142857143,0.1363636364,0.2971428571,22,20,20,22,2,0,0,0,2,1,1,175,157,157,175,18,0
84,116,33,33,0.7567567568,1,0,33,0.9719626168,1,1,1,37,37,37,37,0,1,1,2,2,1,1,321,321,321,321,0,0
15,49,16,35,0.1714285714,0.2285714286,19,25.5,0.3709677419,0.4892473118,0.0857142857,0.376344086,16,35,16,35,19,0,0,0,2,1,1,118,186,118,186,68,0
10,10,1,18,0.0666666667,0.0666666667,17,9.5,0.9619615032,0.9619615032,0.0666666667,0.9619615032,15,1,1,15,14,0,0,0,0,0,0,2182,2099,2099,2182,83,0
535,545,10,11,0.6923076923,0.7692307692,1,10.5,0.7878787879,0.8282828283,0.2307692308,0.6262626263,12,13,12,13,1,0,0,0,2,1,1,82,99,82,99,17,0
610,625,16,16,0.375,1,0,16,0.9239766082,1,1,1,16,16,16,16,0,0,0,0,2,1,1,171,171,171,171,0,1
86,108,23,23,0.6923076923,0.9615384615,0,23,0.9608695652,0.9913043478,0.9230769231,0.9869565217,26,26,26,26,0,1,1,2,2,1,1,230,230,230,230,0,1
502,514,13,13,0.7692307692,0.7692307692,0,13,0.9056603774,0.9150943396,0.1538461538,0.6886792453,13,13,13,13,0,0,0,0,2,1,1,106,104,104,106,2,1
639,646,8,8,0.8888888889,1,0,8,0.9807692308,1,1,1,9,9,9,9,0,1,1,2,2,1,1,52,52,52,52,0,1
137,147,11,11,1,1,0,11,1,1,1,1,11,11,11,11,0,0,0,0,2,1,1,86,86,86,86,0,1
67,83,17,17,0.7368421053,1,0,17,0.9696969697,1,1,1,19,19,19,19,0,1,1,2,2,1,1,165,165,165,165,0,1
285,333,49,54,0.1272727273,0.2181818182,5,51.5,0.3552036199,0.6085972851,0.1272727273,0.4049773756,55,49,49,55,6,0,0,0,2,1,1,438,442,438,442,4,1
40,47,7,8,0.5,0.625,1,7.5,0.7,0.8,0.5,0.7666666667,7,8,7,8,1,0,0,0,3,2,1,30,28,28,30,2,0
97,103,7,7,0.625,0.875,0,7,0.8421052632,0.8947368421,0.375,0.6578947368,8,8,8,8,0,1,1,2,2,1,1,68,76,68,76,8,0
415,433,19,19,1,1,0,19,1,1,1,1,20,20,20,20,0,1,1,2,2,1,1,171,171,171,171,0,1
1098,1112,15,15,0.6,0.8666666667,0,15,0.8489208633,0.9064748201,0.3333333333,0.7769784173,15,15,15,15,0,0,0,0,2,1,1,126,139,126,139,13,0
559,575,17,17,1,1,0,17,1,1,1,1,17,17,17,17,0,0,0,0,2,1,1,119,119,119,119,0,0
672,682,11,11,0.9090909091,0.9090909091,0,11,0.956043956,0.978021978,0.9090909091,0.978021978,11,11,11,11,0,0,0,0,2,1,1,89,91,89,91,2,1
1291,1296,6,6,0.5,0.8333333333,0,6,0.6388888889,0.75,0.8333333333,0.7361111111,6,6,6,6,0,0,0,0,2,1,1,56,72,56,72,16,0
669,683,13,15,0.4666666667,0.8,2,14,0.7248322148,0.8053691275,0.8,0.7583892617,13,15,13,15,2,0,0,0,2,1,1,120,149,120,149,29,0
729,739,11,11,0.6923076923,0.8461538462,0,11,0.9292929293,0.9797979798,0.8461538462,0.9797979798,13,13,13,13,0,0,0,0,2,1,1,99,99,99,99,0,1
10,224,1,215,0.0384615385,0.0384615385,214,108,0.9333036905,0.9333036905,0.0384615385,0.9333036905,1,26,1,26,25,0,1,1,0,0,0,2099,2249,2099,2249,150,0
140,166,27,53,0,0,26,40,0.0041152263,0.3333333333,0,0.0041152263,27,27,27,27,0,0,0,0,1,0,1,216,243,216,243,27,0
470,490,21,21,0.4761904762,0.9523809524,0,21,0.8428571429,0.95,0.9523809524,0.9285714286,21,21,21,21,0,0,1,1,2,1,1,140,134,134,140,6,0
610,646,32,37,0.652173913,0.8260869565,5,34.5,0.9237668161,0.9596412556,0.8260869565,0.9461883408,21,23,21,23,2,1,1,2,4,2,2,218,223,218,223,5,0
274,294,21,21,0,1,0,21,0.8354978355,1,0.2857142857,0.8744588745,21,21,21,21,0,0,0,0,2,1,1,231,231,231,231,0,0
16,71,56,56,1,1,0,56,1,1,1,1,52,52,52,52,0,1,1,2,4,2,2,408,408,408,408,0,0
475,506,32,32,0,0,0,32,0.1904761905,0.2857142857,0,0.2380952381,32,32,32,32,0,0,0,0,2,1,1,672,224,224,672,448,0
354,370,17,17,1,1,0,17,1,1,1,1,17,17,17,17,0,0,0,0,2,1,1,119,119,119,119,0,0
141,148,8,9,0.5555555556,0.7777777778,1,8.5,0.8644067797,0.9152542373,0.7777777778,0.9152542373,9,8,8,9,1,0,0,0,2,1,1,118,109,109,118,9,1
426,466,41,41,1,1,0,41,1,1,1,1,41,41,41,41,0,0,0,0,2,1,1,287,287,287,287,0,0
1032,1042,11,11,0.8461538462,0.9230769231,0,11,0.9763779528,0.9921259843,0.9230769231,0.9842519685,13,13,13,13,0,2,2,4,2,1,1,127,127,127,127,0,1
78,89,12,12,1,1,0,12,1,1,1,1,12,12,12,12,0,1,1,2,2,1,1,119,119,119,119,0,1
776,787,11,12,0.5833333333,0.8333333333,1,11.5,0.8240740741,0.9351851852,0.3333333333,0.75,11,12,11,12,1,0,0,0,2,1,1,105,108,105,108,3,1
126,138,13,13,1,1,0,13,1,1,1,1,13,13,13,13,0,0,0,0,2,1,1,111,111,111,111,0,1
10,1556,1,1547,0.0384615385,0.0384615385,1546,774,0.9333036905,0.9333036905,0.0384615385,0.9333036905,1,26,1,26,25,0,1,1,0,0,0,2099,2249,2099,2249,150,0
87,96,10,10,0.6,0.9,0,10,0.825,0.925,0.9,0.9,10,10,10,10,0,0,0,0,2,1,1,80,77,77,80,3,1
1364,1373,10,10,0.7,0.9,0,10,0.8316831683,0.9554455446,0.9,0.9455445545,10,10,10,10,0,0,0,0,2,1,1,194,202,194,202,8,1
30,44,15,15,1,1,0,15,1,1,1,1,15,15,15,15,0,0,0,0,2,1,1,72,72,72,72,0,1
138,148,11,11,0.2,0.2,0,11,0.3333333333,0.4871794872,0.2,0.3974358974,10,10,10,10,0,1,1,2,4,2,2,78,53,53,78,25,0
159,170,10,12,0.25,0.25,2,11,0.2777777778,0.4305555556,0.25,0.3888888889,11,12,11,12,1,0,0,0,2,1,1,72,53,53,72,19,0
10,10,1,209,0.0357142857,0.0357142857,208,105,0.9316466933,0.9316466933,0.0357142857,0.9316466933,28,1,1,28,27,1,0,1,0,0,0,2253,2099,2099,2253,154,0
52,86,35,35,1,1,0,35,1,1,1,1,18,18,18,18,0,1,1,2,0,0,0,173,173,173,173,0,0
1100,1117,18,18,0.3076923077,1,0,18,0.9010989011,1,1,1,13,13,13,13,0,1,1,2,4,2,2,182,182,182,182,0,1
86,106,21,21,1,1,0,21,1,1,1,1,21,21,21,21,0,0,0,0,2,1,1,164,164,164,164,0,1
109,118,6,10,0.0909090909,0.0909090909,4,8,0.2738095238,0.4047619048,0.0909090909,0.3214285714,7,11,7,11,4,0,3,3,2,1,1,61,84,61,84,23,0
102,111,10,10,1,1,0,10,1,1,1,1,10,10,10,10,0,3,3,6,2,1,1,59,59,59,59,0,1
56,62,7,7,0.1428571429,0.7142857143,0,7,0.5263157895,0.8070175439,0.1428571429,0.5789473684,7,7,7,7,0,0,0,0,2,1,1,49,57,49,57,8,0
73,82,8,10,0.6,0.7,2,9,0.9032258065,0.9193548387,0.7,0.9193548387,9,10,9,10,1,0,0,0,2,1,1,62,62,62,62,0,0
462,493,32,32,1,1,0,32,1,1,1,1,32,32,32,32,0,0,0,0,2,1,1,224,224,224,224,0,1
227,240,11,14,0.625,0.625,3,12.5,0.6585365854,0.6829268293,0.3125,0.5284552846,13,16,13,16,3,0,0,0,2,1,1,95,123,95,123,28,1
497,511,15,18,0.3333333333,0.7222222222,3,16.5,0.6,0.772972973,0.2222222222,0.4918918919,18,15,15,18,3,0,0,0,2,1,1,185,148,148,185,37,0
192,223,32,32,1,1,0,32,1,1,1,1,33,33,33,33,0,0,0,0,2,1,1,235,235,235,235,0,1
585,611,26,27,0.7777777778,0.8888888889,1,26.5,0.8961038961,0.9155844156,0.2592592593,0.6785714286,26,27,26,27,1,4,4,8,2,1,1,282,308,282,308,26,1
28,47,18,20,0.85,0.9,2,19,0.8888888889,0.9,0.9,0.9,18,20,18,20,2,0,0,0,0,0,0,162,180,162,180,18,1
416,424,9,9,0.5555555556,0.8888888889,0,9,0.8541666667,0.9375,0.7777777778,0.9166666667,9,9,9,9,0,0,0,0,2,1,1,46,48,46,48,2,1
358,374,17,17,1,1,0,17,1,1,1,1,17,17,17,17,0,0,0,0,2,1,1,119,119,119,119,0,1
367,379,13,13,1,1,0,13,1,1,1,1,13,13,13,13,0,0,0,0,2,1,1,124,124,124,124,0,1
1496,1509,13,14,0.6428571429,0.9285714286,1,13.5,0.8852459016,0.9262295082,0.4285714286,0.8114754098,13,14,13,14,1,0,0,0,2,1,1,113,122,113,122,9,1
87,103,17,17,1,1,0,17,1,1,1,1,17,17,17,17,0,0,0,0,2,1,1,144,144,144,144,0,1
629,648,20,20,0.8571428571,1,0,20,0.9806451613,1,1,1,21,21,21,21,0,1,1,2,4,2,2,155,155,155,155,0,1
58,66,9,9,0.7,1,0,9,0.9655172414,1,1,1,10,10,10,10,0,1,1,2,2,1,1,87,87,87,87,0,0
373,387,15,15,1,1,0,15,1,1,1,1,15,15,15,15,0,1,1,2,2,1,1,149,149,149,149,0,1
26,31,6,6,0.6666666667,1,0,6,0.9268292683,1,0.8333333333,0.9756097561,6,6,6,6,0,0,0,0,2,1,1,41,41,41,41,0,1
314,322,9,11,0.2,0.2,2,10,0.3510638298,0.5106382979,0.2,0.3723404255,10,8,8,10,2,1,0,1,4,2,2,94,72,72,94,22,0
798,800,3,5,0,0.2,2,4,0.7887323944,0.8169014085,0.2,0.8169014085,5,3,3,5,2,0,0,0,2,1,1,71,61,61,71,10,1
643,653,11,13,0.4666666667,0.6,2,12,0.696969697,0.8181818182,0.2,0.6060606061,15,13,13,15,2,0,0,0,2,1,1,97,99,97,99,2,0
308,322,15,15,1,1,0,15,1,1,1,1,15,15,15,15,0,0,0,0,2,1,1,162,162,162,162,0,1
340,365,26,26,1,1,0,26,1,1,1,1,26,26,26,26,0,0,0,0,2,1,1,182,182,182,182,0,1
321,326,6,6,0,1,0,6,0.7777777778,1,1,1,6,6,6,6,0,0,0,0,2,1,1,63,63,63,63,0,1
395,405,11,12,0.5,0.9166666667,1,11.5,0.8403361345,0.8823529412,0.9166666667,0.8823529412,12,11,11,12,1,0,0,0,2,1,1,119,105,105,119,14,1
212,243,32,32,1,1,0,32,1,1,1,1,33,33,33,33,0,0,0,0,2,1,1,235,235,235,235,0,1
87,116,30,30,0.7333333333,0.9,0,30,0.8509615385,0.8942307692,0.9,0.8846153846,30,30,30,30,0,1,1,2,2,1,1,208,188,188,208,20,1
167,219,35,53,1,1,18,44,1,1,1,1,37,37,37,37,0,1,1,2,4,2,2,285,285,285,285,0,0
503,509,7,7,0.8333333333,0.8333333333,0,7,0.8382352941,0.8823529412,0.8333333333,0.8676470588,6,6,6,6,0,1,1,2,4,2,2,68,62,62,68,6,1
50,56,7,7,0.4285714286,0.7142857143,0,7,0.5483870968,0.6774193548,0.4285714286,0.6129032258,7,7,7,7,0,0,0,0,2,1,1,30,31,30,31,1,0
336,347,12,12,0.5833333333,1,0,12,0.8474576271,1,1,1,12,12,12,12,0,0,0,0,2,1,1,59,59,59,59,0,1
572,592,18,21,0.7391304348,0.7826086957,3,19.5,0.7951807229,0.813253012,0.347826087,0.656626506,20,23,20,23,3,0,0,0,2,1,1,137,166,137,166,29,1
667,685,19,21,0.7391304348,0.7826086957,2,20,0.8192771084,0.8614457831,0.347826087,0.6987951807,23,21,21,23,2,0,0,0,2,1,1,166,149,149,166,17,1
355,380,26,26,1,1,0,26,1,1,1,1,26,26,26,26,0,0,0,0,2,1,1,182,182,182,182,0,0
201,211,11,11,0.2727272727,0.3636363636,0,11,0.46875,0.65625,0.2727272727,0.578125,11,11,11,11,0,0,0,0,2,1,1,61,64,61,64,3,0
299,324,26,26,0,0,0,26,0.4285714286,0.5714285714,0,0.4395604396,26,26,26,26,0,0,0,0,2,1,1,130,182,130,182,52,0
397,413,17,17,1,1,0,17,1,1,1,1,17,17,17,17,0,0,0,0,2,1,1,119,119,119,119,0,0
147,158,12,24,0.125,0.125,12,18,0.1885714286,0.2971428571,0.125,0.2171428571,24,12,12,24,12,0,0,0,2,1,1,175,65,65,175,110,0
46,59,14,25,0.12,0.2,11,19.5,0.3057324841,0.5159235669,0.12,0.3566878981,25,14,14,25,11,0,0,0,2,1,1,157,101,101,157,56,0
37,110,74,87,0.8390804598,0.8390804598,13,80.5,0.8208269525,0.8208269525,0.4597701149,0.6921898928,87,74,74,87,13,0,0,0,2,1,1,653,536,536,653,117,0
391,403,13,13,0.9230769231,0.9230769231,0,13,0.8279569892,0.8494623656,0.3076923077,0.6559139785,13,13,13,13,0,2,2,4,2,1,1,79,93,79,93,14,1
457,466,10,10,1,1,0,10,1,1,1,1,10,10,10,10,0,0,0,0,2,1,1,50,50,50,50,0,1
202,212,11,11,0.9090909091,1,0,11,0.9805825243,1,1,1,11,11,11,11,0,0,0,0,2,1,1,103,103,103,103,0,1
376,389,14,14,0.6875,0.6875,0,14,0.8852459016,0.9180327869,0.3125,0.6967213115,16,16,16,16,0,0,0,0,2,1,1,122,122,122,122,0,1
281,298,18,18,0.8333333333,0.8888888889,0,18,0.9705882353,0.9803921569,0.8888888889,0.9803921569,18,18,18,18,0,0,0,0,2,1,1,102,102,102,102,0,1
975,996,21,22,0.9166666667,0.9166666667,1,21.5,0.9193548387,0.9193548387,0.8333333333,0.8870967742,11,12,11,12,1,1,1,2,0,0,0,57,62,57,62,5,1
208,241,34,34,1,1,0,34,1,1,1,1,35,35,35,35,0,0,0,0,2,1,1,387,387,387,387,0,1
241,251,11,11,0.6363636364,1,0,11,0.9751552795,1,0.8181818182,0.9875776398,11,11,11,11,0,1,1,2,2,1,1,161,161,161,161,0,1
328,347,20,20,1,1,0,20,1,1,1,1,23,23,23,23,0,0,0,0,2,1,1,269,269,269,269,0,1
602,618,17,18,0.3333333333,0.8888888889,1,17.5,0.7405405405,0.9297297297,0.3888888889,0.7891891892,18,17,17,18,1,0,0,0,2,1,1,185,172,172,185,13,0
112,128,17,17,0.5263157895,0.8421052632,0,17,0.8352272727,0.8977272727,0.4210526316,0.6875,19,19,19,19,0,1,0,1,2,1,1,166,176,166,176,10,0
64,71,8,9,0.5555555556,0.6666666667,1,8.5,0.8387096774,0.8548387097,0.6666666667,0.8548387097,9,9,9,9,0,0,0,0,2,1,1,62,62,62,62,0,1
61,81,21,22,0.4736842105,0.9473684211,1,21.5,0.812749004,0.8605577689,0.9473684211,0.8605577689,19,19,19,19,0,1,1,2,3,2,1,251,217,217,251,34,1
381,395,11,15,0.1333333333,0.2666666667,4,13,0.350877193,0.5526315789,0.2,0.4824561404,11,15,11,15,4,0,0,0,2,1,1,75,114,75,114,39,0
10,74,1,65,0.0384615385,0.0384615385,64,33,0.9333036905,0.9333036905,0.0384615385,0.9333036905,1,26,1,26,25,0,1,1,0,0,0,2099,2249,2099,2249,150,0
367,379,13,13,1,1,0,13,1,1,1,1,13,13,13,13,0,0,0,0,2,1,1,124,124,124,124,0,1
783,795,13,13,0.9285714286,1,0,13,0.9913793103,1,1,1,14,14,14,14,0,1,1,2,2,1,1,116,116,116,116,0,1
425,440,6,16,0.125,0.125,10,11,0.3466666667,0.5733333333,0.125,0.4266666667,6,8,6,8,2,0,1,1,3,1,2,59,75,59,75,16,0
30,39,10,16,0.1818181818,0.1818181818,6,13,0.3191489362,0.5425531915,0.1818181818,0.3723404255,11,9,9,11,2,0,0,0,4,2,2,94,73,73,94,21,0
220,231,12,13,0.5384615385,0.8461538462,1,12.5,0.7933884298,0.9256198347,0.3076923077,0.7272727273,13,12,12,13,1,0,0,0,2,1,1,121,118,118,121,3,0
19,26,8,79,0,0.0147058824,71,43.5,0.0105633803,0.0193661972,0,0.014084507,68,2,2,68,66,5,1,6,1,1,0,568,13,13,568,555,0
56,63,8,8,0.5,0.75,0,8,0.9154929577,0.9436619718,0.75,0.9436619718,8,8,8,8,0,0,0,0,2,1,1,71,67,67,71,4,1
61,71,10,11,0.0909090909,0.7272727273,1,10.5,0.5,0.8571428571,0.1818181818,0.6428571429,10,11,10,11,1,0,0,0,2,1,1,40,42,40,42,2,0
77,89,11,13,0.1538461538,0.1538461538,2,12,0.3271028037,0.5420560748,0.1538461538,0.4299065421,11,13,11,13,2,0,0,0,2,1,1,92,107,92,107,15,0
410,444,35,35,1,1,0,35,1,1,1,1,36,36,36,36,0,0,0,0,2,1,1,260,260,260,260,0,1
58,74,17,17,0.5555555556,0.9444444444,0,17,0.868852459,0.9836065574,0.3888888889,0.8278688525,18,18,18,18,0,0,0,0,2,1,1,120,122,120,122,2,1
551,560,10,10,1,1,0,10,1,1,1,1,10,10,10,10,0,0,0,0,2,1,1,46,46,46,46,0,1
506,524,19,19,1,1,0,19,1,1,1,1,20,20,20,20,0,0,0,0,2,1,1,235,235,235,235,0,1
4,21,18,23,0,0.4,5,20.5,0.5151515152,0.8939393939,0.1,0.6363636364,8,10,8,10,2,1,1,2,0,0,0,66,66,66,66,0,0
61,66,6,6,1,1,0,6,1,1,1,1,6,6,6,6,0,0,0,0,2,1,1,60,60,60,60,0,1
519,551,33,33,0.4545454545,1,0,33,0.9127725857,1,1,1,33,33,33,33,0,0,0,0,2,1,1,321,321,321,321,0,1
1496,1509,14,15,0.5333333333,0.9333333333,1,14.5,0.8854961832,0.9312977099,0.8666666667,0.9236641221,15,14,14,15,1,0,0,0,2,1,1,131,122,122,131,9,1
117,132,15,16,0.1875,0.25,1,15.5,0.3055555556,0.4861111111,0.1875,0.3472222222,15,16,15,16,1,0,0,0,2,1,1,104,144,104,144,40,0
186,192,7,7,1,1,0,7,1,1,1,1,7,7,7,7,0,0,0,0,2,1,1,27,27,27,27,0,1
813,831,17,19,0.6315789474,0.7368421053,2,18,0.7985074627,0.8432835821,0.3157894737,0.6567164179,17,19,17,19,2,0,0,0,2,1,1,125,134,125,134,9,1
71,88,18,18,1,1,0,18,1,1,1,1,18,18,18,18,0,1,1,2,2,1,1,101,101,101,101,0,1
283,296,12,14,0.2142857143,0.4285714286,2,13,0.3577981651,0.5871559633,0.2142857143,0.4403669725,12,14,12,14,2,0,0,0,2,1,1,83,109,83,109,26,0
26,55,30,30,0.5,0.9333333333,0,30,0.7584269663,0.9213483146,0.5333333333,0.7752808989,30,30,30,30,0,0,0,0,2,1,1,175,178,175,178,3,1
19,34,16,16,1,1,0,16,1,1,1,1,16,16,16,16,0,0,0,0,2,1,1,119,119,119,119,0,1
48,66,19,19,0.7894736842,1,0,19,0.9754601227,1,1,1,19,19,19,19,0,0,0,0,2,1,1,163,163,163,163,0,1
915,921,7,7,0.75,0.75,0,7,0.8421052632,0.8596491228,0.75,0.8596491228,8,8,8,8,0,0,0,0,2,1,1,57,50,50,57,7,1
1570,1581,12,12,1,1,0,12,1,1,1,1,11,11,11,11,0,1,1,2,2,1,1,102,102,102,102,0,1
507,517,10,11,0.6153846154,0.6923076923,1,10.5,0.7777777778,0.8181818182,0.2307692308,0.6161616162,12,13,12,13,1,0,0,0,2,1,1,82,99,82,99,17,1
459,459,1,1,0,0,0,1,0.2984749455,0.3420479303,0,0.3093681917,1,1,1,1,0,0,0,0,2,1,1,159,459,159,459,300,0
51,55,5,5,0,0.8,0,5,0.6666666667,0.7619047619,0.8,0.7619047619,5,5,5,5,0,0,1,1,2,1,1,84,65,65,84,19,0
480,501,22,22,1,1,0,22,1,1,1,1,22,22,22,22,0,0,0,0,2,1,1,154,154,154,154,0,1
19,34,16,16,1,1,0,16,1,1,1,1,16,16,16,16,0,0,0,0,2,1,1,119,119,119,119,0,1
15,33,19,22,0.0833333333,0.1666666667,3,20.5,0.4302325581,0.7674418605,0.0833333333,0.5930232558,12,9,9,12,3,2,2,4,2,1,1,86,83,83,86,3,0
254,272,19,20,0.6,0.7,1,19.5,0.7596899225,0.8217054264,0.4,0.6976744186,20,19,19,20,1,0,0,0,2,1,1,129,129,129,129,0,1
374,405,32,32,1,1,0,32,1,1,1,1,32,32,32,32,0,0,0,0,2,1,1,224,224,224,224,0,1
4,9,6,6,0.5,0.6666666667,0,6,0.8518518519,0.962962963,0,0.8703703704,6,6,6,6,0,0,0,0,0,0,0,54,54,54,54,0,0
225,231,7,7,0.5714285714,0.7142857143,0,7,0.7142857143,0.8571428571,0.7142857143,0.8,7,7,7,7,0,0,0,0,2,1,1,32,35,32,35,3,0
432,452,15,21,0.0476190476,0.1904761905,6,18,0.38125,0.65,0.0476190476,0.44375,15,21,15,21,6,0,0,0,2,1,1,139,160,139,160,21,0
217,228,12,12,0.5833333333,0.9166666667,0,12,0.8671875,0.9296875,0.5,0.828125,12,12,12,12,0,0,0,0,2,1,1,128,120,120,128,8,1
96,112,17,17,0.5263157895,0.8947368421,0,17,0.8516483516,0.9120879121,0.4736842105,0.7142857143,19,19,19,19,0,1,1,2,2,1,1,182,166,166,182,16,0
648,665,18,19,0.8571428571,0.9047619048,1,18.5,0.8724832215,0.8926174497,0.7142857143,0.8187919463,21,20,20,21,1,0,0,0,2,1,1,149,137,137,149,12,1
459,472,14,14,1,1,0,14,1,1,1,1,14,14,14,14,0,0,0,0,2,1,1,128,128,128,128,0,1
49,59,11,11,0.0909090909,0.9090909091,0,11,0.5050505051,0.8181818182,0.0909090909,0.5050505051,11,11,11,11,0,0,0,0,2,1,1,99,86,86,99,13,0
27,38,12,12,1,1,0,12,1,1,1,1,14,14,14,14,0,0,0,0,2,1,1,133,133,133,133,0,1
106,117,12,12,0.75,1,0,12,0.9210526316,1,1,1,12,12,12,12,0,2,2,4,2,1,1,76,76,76,76,0,0
418,448,31,31,1,1,0,31,1,1,1,1,31,31,31,31,0,4,4,8,2,1,1,125,125,125,125,0,1
955,967,13,13,1,1,0,13,1,1,1,1,13,13,13,13,0,0,0,0,2,1,1,121,121,121,121,0,1
14,76,63,63,1,1,0,63,1,1,1,1,63,63,63,63,0,0,0,0,2,1,1,729,729,729,729,0,1
575,594,20,20,0.9523809524,0.9523809524,0,20,0.9912280702,0.9912280702,0.9523809524,0.9912280702,21,21,21,21,0,0,0,0,2,1,1,114,114,114,114,0,1
31,48,18,21,0.5238095238,0.7619047619,3,19.5,0.6756756757,0.7837837838,0.380952381,0.6824324324,21,18,18,21,3,0,0,0,2,1,1,148,118,118,148,30,1
82,87,6,6,0.8571428571,1,0,6,0.9830508475,1,1,1,7,7,7,7,0,1,1,2,2,1,1,59,59,59,59,0,1
183,197,15,15,1,1,0,15,1,1,1,1,16,16,16,16,0,0,0,0,2,1,1,119,119,119,119,0,1
852,959,108,108,0.9814814815,1,0,108,0.9956076135,1,1,1,108,108,108,108,0,1,1,2,2,1,1,683,683,683,683,0,1
54,62,9,10,0.6,0.7,1,9.5,0.8548387097,0.8709677419,0.7,0.8709677419,10,9,9,10,1,0,0,0,2,1,1,62,62,62,62,0,0
24,42,16,19,0.1578947368,0.1578947368,3,17.5,0.3833333333,0.575,0.1578947368,0.425,16,19,16,19,3,0,0,0,2,1,1,120,120,120,120,0,0
141,152,11,12,0.1666666667,0.3333333333,1,11.5,0.425,0.6875,0.1666666667,0.4875,11,12,11,12,1,0,0,0,3,1,2,80,80,80,80,0,0
662,680,19,19,1,1,0,19,1,1,1,1,21,21,21,21,0,0,0,0,2,1,1,149,149,149,149,0,1
59,76,17,18,0.8888888889,0.9444444444,1,17.5,0.93,0.94,0.8333333333,0.91,17,18,17,18,1,0,0,0,2,1,1,94,100,94,100,6,1
472,480,9,9,0.8888888889,1,0,9,0.993006993,1,1,1,9,9,9,9,0,1,1,2,2,1,1,143,143,143,143,0,1
170,175,6,6,0.5714285714,0.8571428571,0,6,0.9322033898,0.9661016949,0.8571428571,0.9661016949,7,7,7,7,0,1,1,2,2,1,1,59,59,59,59,0,1
114,130,17,17,0.5263157895,0.8947368421,0,17,0.8516483516,0.9120879121,0.4736842105,0.7142857143,19,19,19,19,0,1,1,2,2,1,1,182,166,166,182,16,1
623,663,41,41,1,1,0,41,1,1,1,1,44,44,44,44,0,0,0,0,2,1,1,315,315,315,315,0,1
250,265,16,18,0.3333333333,0.8888888889,2,17,0.8162162162,0.9243243243,0.6666666667,0.8918918919,18,16,16,18,2,0,0,0,2,1,1,185,171,171,185,14,1
20,49,30,30,1,1,0,30,1,1,1,1,31,31,31,31,0,0,0,0,2,1,1,196,196,196,196,0,1
592,602,11,11,1,1,0,11,1,1,1,1,12,12,12,12,0,0,0,0,2,1,1,76,76,76,76,0,1
670,683,14,17,0.3529411765,0.7058823529,3,15.5,0.7362637363,0.8021978022,0.7058823529,0.7857142857,17,14,14,17,3,0,0,0,2,1,1,182,147,147,182,35,1
325,372,48,48,1,1,0,48,1,1,1,1,48,48,48,48,0,0,0,0,2,1,1,336,336,336,336,0,0
68,82,15,23,0.1304347826,0.3043478261,8,19,0.3788819876,0.6273291925,0.1304347826,0.4534161491,23,15,15,23,8,0,0,0,2,1,1,161,120,120,161,41,0
450,480,31,31,1,1,0,31,1,1,1,1,31,31,31,31,0,0,0,0,2,1,1,217,217,217,217,0,0
631,648,18,21,0.7391304348,0.7826086957,3,19.5,0.7951807229,0.813253012,0.347826087,0.656626506,23,20,20,23,3,0,0,0,2,1,1,166,137,137,166,29,1
247,269,23,23,1,1,0,23,1,1,1,1,25,25,25,25,0,0,0,0,2,1,1,202,202,202,202,0,1
478,493,16,17,0.8235294118,0.9411764706,1,16.5,0.8777777778,0.9333333333,0.7058823529,0.8777777778,17,16,16,17,1,0,0,0,2,1,1,90,84,84,90,6,1
312,337,26,26,1,1,0,26,1,1,1,1,26,26,26,26,0,0,0,0,2,1,1,182,182,182,182,0,0
590,601,12,12,1,1,0,12,1,1,1,1,12,12,12,12,0,0,0,0,2,1,1,119,119,119,119,0,1
66,82,17,17,0.7368421053,1,0,17,0.9695121951,1,1,1,19,19,19,19,0,1,1,2,2,1,1,164,164,164,164,0,1
546,570,25,25,0.8461538462,1,0,25,0.9759615385,1,1,1,26,26,26,26,0,1,1,2,4,2,2,208,208,208,208,0,1
74,87,14,14,0.0714285714,0.2142857143,0,14,0.3846153846,0.6307692308,0.0714285714,0.4769230769,14,14,14,14,0,0,0,0,2,1,1,130,118,118,130,12,0
234,255,22,22,0.9090909091,0.9545454545,0,22,0.9777777778,0.9851851852,0.9545454545,0.9851851852,22,22,22,22,0,1,1,2,2,1,1,133,135,133,135,2,1
194,208,15,15,0.6470588235,0.8823529412,0,15,0.8874172185,0.9337748344,0.8235294118,0.9072847682,17,17,17,17,0,0,1,1,2,1,1,149,151,149,151,2,1
628,632,5,5,0.6,1,0,5,0.9733333333,1,1,1,5,5,5,5,0,0,0,0,2,1,1,75,75,75,75,0,0
1028,1045,18,18,0.6842105263,0.8947368421,0,18,0.9336492891,0.9526066351,0.1578947368,0.7488151659,19,19,19,19,0,1,0,1,2,1,1,201,211,201,211,10,1
639,655,17,17,0.8235294118,0.8823529412,0,17,0.9029126214,0.9417475728,0.7058823529,0.8834951456,17,17,17,17,0,0,0,0,2,1,1,103,100,100,103,3,1
30,44,15,15,1,1,0,15,1,1,1,1,15,15,15,15,0,0,0,0,2,1,1,72,72,72,72,0,1
220,231,12,12,0.5833333333,0.9166666667,0,12,0.8559322034,0.9152542373,0.3333333333,0.7542372881,12,12,12,12,0,0,0,0,2,1,1,112,118,112,118,6,1
74,76,3,3,0.3333333333,0.6666666667,0,3,0.8461538462,0.9230769231,0.6666666667,0.9038461538,3,3,3,3,0,0,0,0,2,1,1,52,48,48,52,4,0
64,67,4,4,0.25,1,0,4,0.9347826087,1,1,1,4,4,4,4,0,0,0,0,2,1,1,46,46,46,46,0,1
41,47,6,7,0.7142857143,0.8571428571,1,6.5,0.8780487805,0.9024390244,0.2857142857,0.6829268293,6,7,6,7,1,0,0,0,2,1,1,37,41,37,41,4,1
216,229,14,14,1,1,0,14,1,1,1,1,14,14,14,14,0,0,0,0,2,1,1,107,107,107,107,0,1
308,318,11,11,1,1,0,11,1,1,1,1,12,12,12,12,0,0,0,0,2,1,1,65,65,65,65,0,1
99,111,13,13,1,1,0,13,1,1,1,1,13,13,13,13,0,0,0,0,2,1,1,142,142,142,142,0,1
394,404,11,15,0.4375,0.5,4,13,0.8034682081,0.8554913295,0.125,0.6589595376,16,12,12,16,4,0,0,0,2,1,1,173,159,159,173,14,1
1585,1615,31,31,0.1612903226,1,0,31,0.8617511521,1,1,1,31,31,31,31,0,0,0,0,2,1,1,217,217,217,217,0,1
121,139,4,19,0,0,15,11.5,0.2809917355,0.4545454545,0,0.3305785124,5,12,5,12,7,1,1,2,3,1,2,73,121,73,121,48,0
112,114,3,3,0,1,0,3,0.9,1,1,1,3,3,3,3,0,0,0,0,2,1,1,60,60,60,60,0,0
522,544,19,23,0.68,0.72,4,21,0.7326203209,0.7754010695,0.32,0.6256684492,21,25,21,25,4,0,0,0,2,1,1,149,187,149,187,38,1
112,116,5,5,0.6666666667,1,0,5,0.9672131148,1,1,1,6,6,6,6,0,2,2,4,2,1,1,61,61,61,61,0,1
356,366,11,12,0.5833333333,0.9166666667,1,11.5,0.8559322034,0.8898305085,0.9166666667,0.8898305085,12,11,11,12,1,0,0,0,2,1,1,118,105,105,118,13,0
459,501,43,43,1,1,0,43,1,1,1,1,46,46,46,46,0,0,0,0,2,1,1,314,314,314,314,0,1
758,767,10,10,0.9,1,0,10,0.9910714286,1,1,1,10,10,10,10,0,1,1,2,2,1,1,112,112,112,112,0,1
21,34,14,14,0.7857142857,1,0,14,0.962962963,1,1,1,14,14,14,14,0,2,2,4,2,1,1,81,81,81,81,0,1
1166,1199,34,34,1,1,0,34,1,1,1,1,36,36,36,36,0,0,0,0,2,1,1,257,257,257,257,0,1
247,260,14,15,0.2,0.3333333333,1,14.5,0.2929936306,0.4585987261,0.2,0.3248407643,15,14,14,15,1,0,0,0,2,1,1,98,157,98,157,59,0
8,29,22,22,1,1,0,22,1,1,1,1,23,23,23,23,0,0,0,0,2,1,1,200,200,200,200,0,1
648,665,18,18,1,1,0,18,1,1,1,1,20,20,20,20,0,0,0,0,2,1,1,137,137,137,137,0,1
851,865,15,15,0,0.9333333333,0,15,0.7333333333,0.9333333333,0,0.6571428571,15,15,15,15,0,0,0,0,2,1,1,105,105,105,105,0,1
541,547,7,7,0,1,0,7,0.6666666667,1,1,1,7,7,7,7,0,0,0,0,2,1,1,21,21,21,21,0,0
24,29,6,6,0.3333333333,0.8333333333,0,6,0.7777777778,0.962962963,0.8333333333,0.962962963,6,6,6,6,0,0,0,0,2,1,1,26,27,26,27,1,0
73,79,5,7,0,0.4285714286,2,6,0.7719298246,0.9122807018,0.4285714286,0.8947368421,5,7,5,7,2,0,0,0,2,1,1,56,57,56,57,1,0
239,264,26,26,1,1,0,26,1,1,1,1,15,15,15,15,0,1,1,2,4,2,2,112,112,112,112,0,0
236,242,7,7,1,1,0,7,1,1,1,1,7,7,7,7,0,0,0,0,2,1,1,85,85,85,85,0,1
90,172,83,83,1,1,0,83,1,1,1,1,83,83,83,83,0,0,0,0,2,1,1,756,756,756,756,0,1
266,269,4,4,0,0.5,0,4,0.6721311475,0.8524590164,0.5,0.8360655738,4,4,4,4,0,0,0,0,2,1,1,53,61,53,61,8,0
744,759,12,16,0.375,0.75,4,14,0.6503067485,0.6871165644,0.3125,0.5950920245,12,16,12,16,4,0,0,0,2,1,1,112,163,112,163,51,1
293,304,12,12,1,1,0,12,1,1,1,1,14,14,14,14,0,0,0,0,2,1,1,91,91,91,91,0,1
819,834,16,16,0.375,1,0,16,0.8713450292,1,1,1,16,16,16,16,0,0,0,0,2,1,1,171,171,171,171,0,1
226,235,10,10,0.9,1,0,10,0.9772727273,1,1,1,10,10,10,10,0,0,0,0,2,1,1,44,44,44,44,0,1
172,188,17,17,1,1,0,17,1,1,1,1,19,19,19,19,0,1,1,2,2,1,1,147,147,147,147,0,1
39,51,13,15,0.2,0.2666666667,2,14,0.3243243243,0.5067567568,0.2,0.3986486486,15,14,14,15,1,0,0,0,2,1,1,148,107,107,148,41,0
548,570,23,23,0.88,1,0,23,0.9786096257,1,1,1,25,25,25,25,0,0,0,0,2,1,1,187,187,187,187,0,1
734,767,28,34,0.7916666667,0.8333333333,6,31,0.875862069,0.8965517241,0.8333333333,0.8896551724,21,24,21,24,3,1,1,2,4,2,2,131,145,131,145,14,1
277,288,11,12,0.5833333333,0.9166666667,1,11.5,0.9017857143,0.9375,0.3333333333,0.7767857143,11,12,11,12,1,0,0,0,2,1,1,105,112,105,112,7,1
186,190,5,16,0,0,11,10.5,0.303030303,0.5303030303,0,0.4242424242,11,5,5,11,6,2,1,3,3,2,1,66,55,55,66,11,0
166,178,13,13,1,1,0,13,1,1,1,1,15,15,15,15,0,2,2,4,2,1,1,141,141,141,141,0,1
22,35,14,19,0.2105263158,0.3157894737,5,16.5,0.3863636364,0.5909090909,0.2631578947,0.4886363636,19,15,15,19,4,0,0,0,2,1,1,87,88,87,88,1,0
73,86,14,14,1,1,0,14,1,1,1,1,15,15,15,15,0,0,0,0,2,1,1,105,105,105,105,0,1
61,74,14,16,0.25,0.3125,2,15,0.393442623,0.5901639344,0.25,0.4508196721,16,14,14,16,2,0,0,0,2,1,1,122,102,102,122,20,0
396,423,28,56,0.0892857143,0.1964285714,28,42,0.3071161049,0.4494382022,0.0892857143,0.329588015,56,28,28,56,28,0,0,0,2,1,1,267,172,172,267,95,0
386,399,14,14,0.6875,0.6875,0,14,0.8852459016,0.9180327869,0.5625,0.8770491803,16,16,16,16,0,0,0,0,2,1,1,122,122,122,122,0,1
135,149,15,15,0.5,0.8333333333,0,15,0.7885714286,0.8628571429,0.25,0.5885714286,12,12,12,12,0,0,0,0,4,2,2,175,168,168,175,7,1
1238,1252,15,15,0.7333333333,1,0,15,0.9557522124,1,1,1,15,15,15,15,0,0,0,0,2,1,1,113,113,113,113,0,1
483,500,18,18,1,1,0,18,1,1,1,1,18,18,18,18,0,1,1,2,2,1,1,164,164,164,164,0,1
1195,1340,146,146,0.9913043478,0.9913043478,0,146,0.9966405375,0.9966405375,0.9913043478,0.9966405375,115,115,115,115,0,1,1,2,4,2,2,893,890,890,893,3,1
14,37,22,24,0.6538461538,0.8461538462,2,23,0.7957446809,0.8510638298,0.6923076923,0.8,23,26,23,26,3,0,0,0,2,1,1,200,235,200,235,35,1
141,155,15,18,0.3333333333,0.7222222222,3,16.5,0.6,0.772972973,0.2222222222,0.4918918919,18,15,15,18,3,0,0,0,2,1,1,185,148,148,185,37,0
506,524,19,19,1,1,0,19,1,1,1,1,20,20,20,20,0,0,0,0,2,1,1,235,235,235,235,0,1
98,140,43,43,0.8620689655,1,0,43,0.9856115108,1,1,1,29,29,29,29,0,1,1,2,2,1,1,278,278,278,278,0,0
661,708,48,48,0.4042553191,0.5106382979,0,48,0.5198675497,0.5860927152,0.5106382979,0.5397350993,47,29,29,47,18,0,3,3,3,2,1,302,196,196,302,106,0
763,768,6,6,0.8571428571,1,0,6,0.9558823529,1,0.8571428571,0.9558823529,7,7,7,7,0,0,0,0,2,1,1,68,68,68,68,0,1
253,270,18,32,0.125,0.1875,14,25,0.2873563218,0.4674329502,0.125,0.3295019157,32,18,18,32,14,0,0,0,2,1,1,261,177,177,261,84,0
438,468,31,31,1,1,0,31,1,1,1,1,31,31,31,31,0,0,0,0,2,1,1,217,217,217,217,0,1
273,288,16,16,0.3125,0.9375,0,16,0.7301587302,0.9682539683,0.9375,0.9682539683,16,16,16,16,0,0,0,0,2,1,1,62,63,62,63,1,1
6,45,40,40,1,1,0,40,1,1,1,1,39,39,39,39,0,2,2,4,2,1,1,364,364,364,364,0,1
108,114,7,8,0.5,0.75,1,7.5,0.780952381,0.8380952381,0.5,0.8,8,7,7,8,1,0,0,0,2,1,1,105,88,88,105,17,0
112,144,33,33,0.5405405405,0.8918918919,0,33,0.8699421965,0.9306358382,0.3783783784,0.7225433526,37,37,37,37,0,1,1,2,2,1,1,330,346,330,346,16,1
38,69,32,32,1,1,0,32,1,1,1,1,33,33,33,33,0,2,2,4,2,1,1,243,243,243,243,0,1
135,182,48,48,1,1,0,48,1,1,1,1,48,48,48,48,0,0,0,0,2,1,1,318,318,318,318,0,1
498,505,8,8,0.5,0.75,0,8,0.7142857143,0.8857142857,0.5,0.7714285714,8,8,8,8,0,0,0,0,2,1,1,33,35,33,35,2,0
394,403,10,11,0.2727272727,0.3636363636,1,10.5,0.369047619,0.5833333333,0.2727272727,0.5238095238,11,11,11,11,0,0,0,0,2,1,1,75,84,75,84,9,0
637,647,11,11,1,1,0,11,1,1,1,1,11,11,11,11,0,3,3,6,2,1,1,115,115,115,115,0,1
1256,1263,8,8,0,1,0,8,0.5714285714,1,0,0.7321428571,8,8,8,8,0,0,0,0,2,1,1,56,56,56,56,0,0
62,78,17,17,0.5263157895,0.8421052632,0,17,0.8076923077,0.8681318681,0.4210526316,0.6648351648,19,19,19,19,0,1,0,1,2,1,1,182,160,160,182,22,1
493,504,12,14,0.4285714286,0.8571428571,2,13,0.768707483,0.8095238095,0.8571428571,0.8095238095,14,12,12,14,2,0,0,0,2,1,1,147,119,119,147,28,1
147,153,6,7,0.2857142857,0.7142857143,1,6.5,0.475,0.65,0.7142857143,0.625,6,7,6,7,1,0,0,0,2,1,1,26,40,26,40,14,0
656,667,12,12,0.5833333333,0.9166666667,0,12,0.8559322034,0.9406779661,0.3333333333,0.7542372881,12,12,12,12,0,0,0,0,2,1,1,118,114,114,118,4,1
255,260,6,6,0,0.8333333333,0,6,0.8409090909,0.9242424242,0.6666666667,0.8484848485,6,6,6,6,0,0,0,0,2,1,1,123,132,123,132,9,0
313,344,32,37,0.3913043478,0.8260869565,5,34.5,0.8340807175,0.9596412556,0.8260869565,0.9461883408,23,21,21,23,2,1,1,2,4,2,2,223,218,218,223,5,1
300,338,39,39,1,1,0,39,1,1,1,1,39,39,39,39,0,0,0,0,2,1,1,297,297,297,297,0,1
202,265,64,64,1,1,0,64,1,1,1,1,64,64,64,64,0,0,0,0,2,1,1,511,511,511,511,0,1
595,608,14,14,0.8333333333,1,0,14,0.9837837838,1,1,1,18,18,18,18,0,0,0,0,2,1,1,185,185,185,185,0,1
967,984,18,18,0.8333333333,1,0,18,0.9591836735,1,0.3333333333,0.7653061224,18,18,18,18,0,0,0,0,2,1,1,98,98,98,98,0,1
116,130,15,15,0.6470588235,0.9411764706,0,15,0.9523809524,0.9863945578,0.9411764706,0.9863945578,17,17,17,17,0,0,0,0,2,1,1,147,147,147,147,0,1
86,89,4,4,1,1,0,4,1,1,1,1,4,4,4,4,0,1,1,2,2,1,1,75,75,75,75,0,1
307,321,15,15,1,1,0,15,1,1,1,1,15,15,15,15,0,0,0,0,2,1,1,140,140,140,140,0,1
159,165,7,7,0.8571428571,0.8571428571,0,7,0.9302325581,0.9534883721,0.8571428571,0.9534883721,7,7,7,7,0,0,0,0,2,1,1,82,86,82,86,4,1
53,74,22,42,0.1666666667,0.380952381,20,32,0.3691588785,0.5280373832,0.2380952381,0.4112149533,42,22,22,42,20,0,0,0,2,1,1,214,123,123,214,91,0
1487,1496,10,10,1,1,0,10,1,1,1,1,10,10,10,10,0,0,0,0,2,1,1,50,50,50,50,0,1
85,136,13,52,0.0384615385,0.1153846154,39,32.5,0.165,0.2725,0.0384615385,0.1875,14,52,14,52,38,0,0,0,2,1,1,131,400,131,400,269,0
220,230,11,11,0.6363636364,1,0,11,0.9295774648,1,1,1,11,11,11,11,0,0,0,0,2,1,1,71,71,71,71,0,1
381,410,30,30,0,0,0,30,0.4285714286,0.5714285714,0,0.4380952381,30,30,30,30,0,0,0,0,2,1,1,150,210,150,210,60,0
1218,1382,165,165,0.9745762712,0.9830508475,0,165,0.9900662252,0.9933774834,0.2627118644,0.7759381898,118,118,118,118,0,0,0,0,4,2,2,900,906,900,906,6,1
44,55,12,13,0.7142857143,0.7857142857,1,12.5,0.7967479675,0.8048780488,0.7142857143,0.7804878049,14,12,12,14,2,0,0,0,2,1,1,123,99,99,123,24,1
324,353,30,30,1,1,0,30,1,1,1,1,30,30,30,30,0,0,0,0,2,1,1,210,210,210,210,0,1
276,285,10,10,1,1,0,10,1,1,1,1,10,10,10,10,0,0,0,0,2,1,1,44,44,44,44,0,1
458,489,32,32,1,1,0,32,1,1,1,1,32,32,32,32,0,0,0,0,2,1,1,224,224,224,224,0,1
574,584,9,11,0.6153846154,0.7692307692,2,10,0.696969697,0.7272727273,0.3846153846,0.5555555556,11,13,11,13,2,0,0,0,2,1,1,75,99,75,99,24,1
228,241,14,14,1,1,0,14,1,1,1,1,14,14,14,14,0,0,0,0,2,1,1,107,107,107,107,0,1
1148,1175,28,28,0.9655172414,0.9655172414,0,28,0.9828571429,0.9828571429,0.3103448276,0.8114285714,29,29,29,29,0,1,1,2,2,1,1,350,344,344,350,6,1
510,520,11,11,1,1,0,11,1,1,1,1,11,11,11,11,0,4,4,8,2,1,1,60,60,60,60,0,1
428,438,11,11,0.5454545455,1,0,11,0.8421052632,1,1,1,11,11,11,11,0,0,0,0,2,1,1,57,57,57,57,0,1
112,128,17,17,0.7368421053,1,0,17,0.9695121951,1,1,1,19,19,19,19,0,1,1,2,2,1,1,164,164,164,164,0,1
425,434,10,10,0.75,0.8333333333,0,10,0.8953488372,0.9534883721,0.3333333333,0.7325581395,12,12,12,12,0,0,0,0,2,1,1,86,82,82,86,4,1
835,861,27,27,1,1,0,27,1,1,1,1,27,27,27,27,0,0,0,0,2,1,1,193,193,193,193,0,1
17,35,18,19,0.5789473684,0.8421052632,1,18.5,0.868852459,0.9180327869,0.2631578947,0.6721311475,18,19,18,19,1,0,0,0,2,1,1,113,122,113,122,9,1
17,25,9,9,1,1,0,9,1,1,1,1,11,11,11,11,0,0,0,0,2,1,1,114,114,114,114,0,1
1378,1420,43,51,0.3333333333,0.8431372549,8,47,0.7703081232,0.8431372549,0.8431372549,0.8431372549,51,43,43,51,8,0,0,0,2,1,1,357,301,301,357,56,1
472,495,24,24,1,1,0,24,1,1,1,1,24,24,24,24,0,0,0,0,2,1,1,168,168,168,168,0,0
73,82,10,10,1,1,0,10,1,1,1,1,10,10,10,10,0,0,0,0,2,1,1,62,62,62,62,0,1
729,737,8,9,0.7272727273,0.7272727273,1,8.5,0.76,0.8,0.2727272727,0.6,10,11,10,11,1,0,0,0,2,1,1,62,75,62,75,13,0
396,404,9,9,0.5555555556,0.8888888889,0,9,0.7457627119,0.7966101695,0.8888888889,0.7966101695,9,9,9,9,0,0,0,0,2,1,1,47,59,47,59,12,0
95,115,10,21,0.1,0.1,11,15.5,0.3442622951,0.5245901639,0.1,0.4098360656,10,9,9,10,1,1,2,3,3,1,2,61,61,61,61,0,0
648,665,18,18,1,1,0,18,1,1,1,1,20,20,20,20,0,0,0,0,2,1,1,137,137,137,137,0,1
118,142,25,25,0.6071428571,1,0,25,0.9465020576,1,1,1,28,28,28,28,0,1,1,2,2,1,1,243,243,243,243,0,1
5,34,27,30,0,0,3,28.5,0.3258426966,0.4831460674,0,0.3483146067,11,8,8,11,3,2,2,4,3,2,1,71,89,71,89,18,0
446,508,63,63,1,1,0,63,1,1,1,1,63,63,63,63,0,0,0,0,2,1,1,455,455,455,455,0,1
1541,1547,7,7,0.8333333333,1,0,7,0.9814814815,1,1,1,6,6,6,6,0,1,1,2,2,1,1,54,54,54,54,0,1
475,484,10,10,0.1,1,0,10,0.8636363636,1,0.2,0.8636363636,10,10,10,10,0,0,0,0,2,1,1,110,110,110,110,0,0
87,165,79,79,1,1,0,79,1,1,1,1,20,20,20,20,0,1,1,2,0,0,0,2087,2087,2087,2087,0,1
414,493,80,80,1,1,0,80,1,1,1,1,80,80,80,80,0,0,0,0,2,1,1,560,560,560,560,0,1
54,62,8,9,0.5555555556,0.6666666667,1,8.5,0.8387096774,0.8548387097,0.6666666667,0.8548387097,9,9,9,9,0,0,0,0,2,1,1,62,62,62,62,0,1
1515,1530,16,17,0.6470588235,0.7647058824,1,16.5,0.8198198198,0.9009009009,0.2352941176,0.6666666667,17,16,16,17,1,0,0,0,2,1,1,111,104,104,111,7,0
415,422,8,8,1,1,0,8,1,1,1,1,9,9,9,9,0,3,3,6,2,1,1,129,129,129,129,0,1
153,158,6,7,0.5714285714,0.7142857143,1,6.5,0.6774193548,0.7741935484,0.4285714286,0.6774193548,7,6,6,7,1,0,0,0,4,2,2,27,31,27,31,4,1
27,41,15,15,1,1,0,15,1,1,1,1,14,14,14,14,0,3,3,6,2,1,1,131,131,131,131,0,1
624,641,18,23,0.68,0.72,5,20.5,0.7165775401,0.7326203209,0.32,0.5989304813,25,20,20,25,5,0,0,0,2,1,1,187,137,137,187,50,1
832,840,9,9,0.6,1,0,9,0.8732394366,1,1,1,10,10,10,10,0,0,0,0,2,1,1,71,71,71,71,0,1
140,146,7,7,0.625,1,0,7,0.9240506329,1,1,1,8,8,8,8,0,0,0,0,2,1,1,79,79,79,79,0,0
126,138,13,13,1,1,0,13,1,1,1,1,13,13,13,13,0,0,0,0,2,1,1,111,111,111,111,0,1
1513,1527,14,15,0.0666666667,0.8,1,14.5,0.3076923077,0.5266272189,0.0666666667,0.3313609467,14,15,14,15,1,0,0,0,2,1,1,169,104,104,169,65,0
168,187,20,22,0.2272727273,0.3181818182,2,21,0.3563829787,0.5638297872,0.2272727273,0.3882978723,22,22,22,22,0,0,0,0,2,1,1,149,188,149,188,39,0
131,137,7,7,0.625,0.875,0,7,0.8421052632,0.8947368421,0.375,0.6578947368,8,8,8,8,0,1,1,2,2,1,1,76,68,68,76,8,1
522,544,23,23,1,1,0,23,1,1,1,1,25,25,25,25,0,0,0,0,2,1,1,187,187,187,187,0,1
648,667,20,20,0.8571428571,1,0,20,0.9806451613,1,1,1,21,21,21,21,0,1,1,2,4,2,2,155,155,155,155,0,1
278,283,5,6,0,0,1,5.5,0.3220338983,0.5423728814,0,0.4237288136,5,6,5,6,1,1,1,2,2,1,1,59,54,54,59,5,0
111,117,7,8,0,0.5,1,7.5,0.7654320988,0.9382716049,0.5,0.9382716049,8,7,7,8,1,0,0,0,2,1,1,81,81,81,81,0,0
1467,1527,61,61,0.625,1,0,61,0.8227848101,1,0.9821428571,0.9957805907,56,56,56,56,0,1,1,2,4,2,2,237,237,237,237,0,0
351,357,7,7,0.8571428571,1,0,7,0.9833333333,1,1,1,7,7,7,7,0,1,1,2,2,1,1,60,60,60,60,0,1
110,197,88,88,1,1,0,88,1,1,1,1,88,88,88,88,0,0,0,0,2,1,1,484,484,484,484,0,1
910,922,13,15,0.4666666667,0.8,2,14,0.6967741935,0.7741935484,0.3333333333,0.6516129032,15,13,13,15,2,0,0,0,2,1,1,155,121,121,155,34,1
1155,1170,16,16,1,1,0,16,1,1,1,1,16,16,16,16,0,0,0,0,2,1,1,128,128,128,128,0,1
795,803,9,9,0.6666666667,0.8888888889,0,9,0.8648648649,0.9459459459,0.1111111111,0.6891891892,9,9,9,9,0,2,2,4,2,1,1,74,71,71,74,3,1
27,54,28,28,0.7142857143,0.9642857143,0,28,0.8679245283,0.9748427673,0.5714285714,0.8616352201,28,28,28,28,0,0,0,0,2,1,1,155,159,155,159,4,1
90,172,83,83,1,1,0,83,1,1,1,1,83,83,83,83,0,0,0,0,2,1,1,756,756,756,756,0,1
128,139,12,12,0.9166666667,1,0,12,0.9913793103,1,1,1,12,12,12,12,0,0,0,0,2,1,1,116,116,116,116,0,1
293,304,12,12,1,1,0,12,1,1,1,1,14,14,14,14,0,0,0,0,2,1,1,91,91,91,91,0,1
261,269,9,9,1,1,0,9,1,1,1,1,10,10,10,10,0,1,1,2,2,1,1,109,109,109,109,0,0
52,98,47,47,1,1,0,47,1,1,1,1,24,24,24,24,0,0,0,0,0,0,0,216,216,216,216,0,1
276,288,13,13,0.6153846154,0.9230769231,0,13,0.9310344828,0.974137931,0.3846153846,0.8103448276,13,13,13,13,0,0,0,0,2,1,1,116,114,114,116,2,0
199,203,5,5,0,0,0,5,0.5616438356,0.8630136986,0,0.7945205479,5,5,5,5,0,1,1,2,2,1,1,63,73,63,73,10,0
19,41,23,23,0.8333333333,0.875,0,23,0.9345794393,0.9485981308,0.1666666667,0.6869158879,24,24,24,24,0,0,0,0,2,1,1,214,214,214,214,0,1
173,207,35,35,1,1,0,35,1,1,1,1,28,28,28,28,0,1,1,2,2,1,1,178,178,178,178,0,1
356,372,17,19,0.7368421053,0.7894736842,2,18,0.7868852459,0.8114754098,0.2631578947,0.5983606557,19,17,17,19,2,0,0,0,2,1,1,122,100,100,122,22,1
54,62,9,9,1,1,0,9,1,1,1,1,9,9,9,9,0,0,0,0,4,2,2,59,59,59,59,0,1
345,354,10,10,0.3,1,0,10,0.7283950617,1,0.5,0.7654320988,10,10,10,10,0,0,0,0,2,1,1,81,81,81,81,0,0
10,1468,1,1459,0.0384615385,0.0384615385,1458,730,0.9333036905,0.9333036905,0.0384615385,0.9333036905,1,26,1,26,25,0,1,1,0,0,0,2099,2249,2099,2249,150,0
546,557,12,12,0.5833333333,0.9166666667,0,12,0.8559322034,0.9406779661,0.3333333333,0.7542372881,12,12,12,12,0,0,0,0,2,1,1,118,114,114,118,4,1
8,31,22,24,0.6538461538,0.8461538462,2,23,0.7957446809,0.8510638298,0.6923076923,0.8,23,26,23,26,3,0,0,0,2,1,1,200,235,200,235,35,1
343,348,6,16,0,0.2222222222,10,11,0.2467532468,0.4675324675,0,0.3116883117,9,7,7,9,2,0,2,2,3,2,1,77,68,68,77,9,0
522,540,19,19,1,1,0,19,1,1,1,1,20,20,20,20,0,0,0,0,2,1,1,235,235,235,235,0,1
126,306,181,181,1,1,0,181,1,1,1,1,175,175,175,175,0,1,1,2,4,2,2,1341,1341,1341,1341,0,1
212,222,11,11,1,1,0,11,1,1,1,1,11,11,11,11,0,0,0,0,2,1,1,77,77,77,77,0,1
857,865,9,9,0.6,0.7,0,9,0.6197183099,0.7323943662,0.4,0.661971831,9,10,9,10,1,0,0,0,2,1,1,53,71,53,71,18,0
1036,1051,16,18,0.2777777778,0.4444444444,2,17,0.3917525773,0.5773195876,0.2777777778,0.4432989691,18,16,16,18,2,0,0,0,2,1,1,75,97,75,97,22,0
168,173,6,6,0.5,0.8333333333,0,6,0.8076923077,0.9615384615,0.5,0.8846153846,6,6,6,6,0,0,0,0,2,1,1,26,26,26,26,0,0
99,111,13,13,1,1,0,13,1,1,1,1,13,13,13,13,0,0,0,0,2,1,1,117,117,117,117,0,1
999,1014,16,16,0.5,0.9444444444,0,16,0.8563829787,0.9627659574,0.9444444444,0.9627659574,18,18,18,18,0,0,0,0,2,1,1,181,188,181,188,7,1
479,494,16,16,0.375,1,0,16,0.8713450292,1,1,1,16,16,16,16,0,0,0,0,2,1,1,171,171,171,171,0,1
546,568,18,23,0.68,0.72,5,20.5,0.7165775401,0.7326203209,0.32,0.5989304813,20,25,20,25,5,0,0,0,2,1,1,137,187,137,187,50,1
775,782,7,8,0.125,0.75,1,7.5,0.4827586207,0.775862069,0.125,0.5689655172,7,8,7,8,1,0,0,0,2,1,1,53,58,53,58,5,0
373,383,11,11,1,1,0,11,1,1,1,1,13,13,13,13,0,0,0,0,2,1,1,95,95,95,95,0,1
110,197,88,88,1,1,0,88,1,1,1,1,88,88,88,88,0,0,0,0,2,1,1,484,484,484,484,0,1
804,816,13,13,1,1,0,13,1,1,1,1,13,13,13,13,0,0,0,0,2,1,1,122,122,122,122,0,1
341,364,24,24,0,0,0,24,0.4285714286,0.5714285714,0,0.4404761905,24,24,24,24,0,0,0,0,2,1,1,120,168,120,168,48,0
298,353,56,56,1,1,0,56,1,1,1,1,58,58,58,58,0,0,0,0,2,1,1,597,597,597,597,0,1
404,418,15,15,1,1,0,15,1,1,1,1,15,15,15,15,0,0,0,0,2,1,1,107,107,107,107,0,1
121,124,4,4,0.6,1,0,4,0.96875,1,1,1,5,5,5,5,0,1,1,2,2,1,1,64,64,64,64,0,1
468,501,32,34,0.5882352941,0.7352941176,2,33,0.7867132867,0.9160839161,0.3823529412,0.7307692308,32,34,32,34,2,0,0,0,2,1,1,284,286,284,286,2,1
874,889,16,16,0.875,1,0,16,0.9871794872,1,1,1,16,16,16,16,0,2,2,4,2,1,1,156,156,156,156,0,1
77,101,25,25,0.9615384615,0.9615384615,0,25,0.9852941176,0.9901960784,0.9615384615,0.9901960784,26,26,26,26,0,0,0,0,2,1,1,202,204,202,204,2,1
606,613,8,9,0.4444444444,0.6666666667,1,8.5,0.7733333333,0.88,0.6666666667,0.84,9,8,8,9,1,0,0,0,2,1,1,75,68,68,75,7,1
87,110,24,26,0.8461538462,0.9230769231,2,25,0.7656903766,0.7740585774,0.6153846154,0.7071129707,26,24,24,26,2,0,0,0,2,1,1,239,185,185,239,54,1
34,36,3,3,0.3333333333,1,0,3,0.9285714286,1,1,1,3,3,3,3,0,0,0,0,2,1,1,56,56,56,56,0,0
136,192,57,57,1,1,0,57,1,1,1,1,53,53,53,53,0,1,1,2,4,2,2,348,348,348,348,0,1
225,230,6,6,0.3333333333,0.8333333333,0,6,0.6923076923,0.8846153846,0.8333333333,0.8846153846,6,6,6,6,0,0,0,0,2,1,1,25,26,25,26,1,0
991,1003,13,16,0.5625,0.8125,3,14.5,0.7375886525,0.7730496454,0.375,0.6737588652,16,13,13,16,3,0,0,0,2,1,1,141,109,109,141,32,0
194,203,10,10,1,1,0,10,1,1,1,1,8,8,8,8,0,0,0,0,2,1,1,59,59,59,59,0,1
463,505,43,43,1,1,0,43,1,1,1,1,46,46,46,46,0,0,0,0,2,1,1,314,314,314,314,0,1
874,900,27,27,0.8148148148,0.8148148148,0,27,0.9698492462,0.9698492462,0.8148148148,0.9698492462,27,27,27,27,0,0,0,0,2,1,1,199,193,193,199,6,1
671,685,13,15,0.625,0.6875,2,14,0.6936936937,0.7567567568,0.5,0.6306306306,14,16,14,16,2,0,0,0,2,1,1,89,111,89,111,22,1
322,360,39,39,0.9487179487,0.9487179487,0,39,0.9736842105,0.9736842105,0.4871794872,0.7302631579,39,39,39,39,0,0,0,0,2,1,1,304,296,296,304,8,1
954,967,12,14,0.5714285714,0.8571428571,2,13,0.7967479675,0.8699186992,0.3571428571,0.7154471545,12,14,12,14,2,0,0,0,2,1,1,107,123,107,123,16,0
66,82,17,17,0.8421052632,1,0,17,0.9817073171,1,1,1,19,19,19,19,0,1,1,2,2,1,1,164,164,164,164,0,1
775,787,13,15,0.4666666667,0.7333333333,2,14,0.6530612245,0.7414965986,0.3333333333,0.612244898,15,13,13,15,2,0,0,0,2,1,1,147,110,110,147,37,0
31,54,24,24,1,1,0,24,1,1,1,1,24,24,24,24,0,0,0,0,2,1,1,164,164,164,164,0,1
194,203,10,10,1,1,0,10,1,1,1,1,8,8,8,8,0,0,0,0,2,1,1,59,59,59,59,0,1
254,256,3,3,0.6666666667,1,0,3,0.9818181818,1,1,1,3,3,3,3,0,0,0,0,2,1,1,55,55,55,55,0,1
149,200,52,52,1,1,0,52,1,1,1,1,51,51,51,51,0,1,1,2,4,2,2,376,376,376,376,0,0
910,922,13,14,0.4285714286,0.8571428571,1,13.5,0.7482014388,0.8705035971,0.2857142857,0.7050359712,14,13,13,14,1,0,0,0,2,1,1,139,121,121,139,18,0
495,501,7,7,1,1,0,7,1,1,1,1,7,7,7,7,0,0,0,0,2,1,1,51,51,51,51,0,1
339,447,109,109,1,1,0,109,1,1,1,1,46,46,46,46,0,0,0,0,4,2,2,322,322,322,322,0,1
1600,1604,5,5,0.8,1,0,5,0.9838709677,1,1,1,5,5,5,5,0,0,0,0,2,1,1,62,62,62,62,0,1
10,10,1,32,0.0384615385,0.0384615385,31,16.5,0.9324744558,0.9324744558,0.0384615385,0.9324744558,26,1,1,26,25,1,0,1,1,1,0,2251,2099,2099,2251,152,0
82,98,17,17,0.7368421053,1,0,17,0.9696969697,1,1,1,19,19,19,19,0,1,1,2,2,1,1,165,165,165,165,0,0
1549,1565,15,17,0.5882352941,0.7647058824,2,16,0.8591549296,0.9436619718,0.5294117647,0.8661971831,15,17,15,17,2,0,0,0,2,1,1,139,142,139,142,3,1
372,383,12,12,0.4166666667,1,0,12,0.9066666667,1,1,1,12,12,12,12,0,0,0,0,2,1,1,75,75,75,75,0,1
471,502,32,32,1,1,0,32,1,1,1,1,32,32,32,32,0,0,0,0,2,1,1,224,224,224,224,0,1
1132,1138,7,7,0.4285714286,0.7142857143,0,7,0.4791666667,0.625,0.4285714286,0.4583333333,7,7,7,7,0,0,0,0,2,1,1,48,32,32,48,16,0
629,646,18,18,0.9,1,0,18,0.9854014599,1,1,1,20,20,20,20,0,0,0,0,2,1,1,137,137,137,137,0,1
297,306,10,10,1,1,0,10,1,1,1,1,10,10,10,10,0,0,0,0,2,1,1,77,77,77,77,0,1
369,379,11,12,0.5833333333,0.9166666667,1,11.5,0.8859649123,0.9210526316,0.3333333333,0.7719298246,12,11,11,12,1,0,0,0,2,1,1,114,105,105,114,9,1
126,138,13,13,1,1,0,13,1,1,1,1,13,13,13,13,0,0,0,0,2,1,1,111,111,111,111,0,1
874,900,27,27,1,1,0,27,1,1,1,1,27,27,27,27,0,0,0,0,2,1,1,193,193,193,193,0,1
128,144,17,17,0.5263157895,0.9473684211,0,17,0.9248554913,0.9884393064,0.9473684211,0.9884393064,19,19,19,19,0,1,1,2,2,1,1,173,173,173,173,0,1
98,132,35,35,1,1,0,35,1,1,1,1,37,37,37,37,0,1,1,2,4,2,2,285,285,285,285,0,0
214,239,26,26,0.7307692308,0.8076923077,0,26,0.8457446809,0.8776595745,0.5,0.7659574468,26,26,26,26,0,0,0,0,2,1,1,188,173,173,188,15,1
522,544,23,23,0.88,1,0,23,0.9786096257,1,1,1,25,25,25,25,0,0,0,0,2,1,1,187,187,187,187,0,1
31,37,7,7,0.5714285714,0.8571428571,0,7,0.6,0.7,0.7142857143,0.6666666667,7,7,7,7,0,0,0,0,2,1,1,27,30,27,30,3,0
293,334,42,43,0.8666666667,0.9111111111,1,42.5,0.9907407407,0.9944444444,0.5777777778,0.8851851852,45,44,44,45,1,0,0,0,2,1,1,540,539,539,540,1,1
60,65,6,6,0.625,0.625,0,6,0.7931034483,0.7931034483,0.625,0.7931034483,6,8,6,8,2,1,0,1,2,1,1,70,87,70,87,17,1
114,130,17,17,1,1,0,17,1,1,1,1,19,19,19,19,0,1,1,2,2,1,1,147,147,147,147,0,1
425,447,23,23,1,1,0,23,1,1,1,1,23,23,23,23,0,0,0,0,2,1,1,124,124,124,124,0,1
24,35,12,20,0.2,0.3,8,16,0.3106060606,0.4772727273,0.25,0.3787878788,20,12,12,20,8,0,0,0,2,1,1,132,70,70,132,62,0
1140,1149,10,23,0.0869565217,0.0869565217,13,16.5,0.1972789116,0.2993197279,0.0869565217,0.1972789116,23,10,10,23,13,0,0,0,2,1,1,147,56,56,147,91,0
100,113,14,14,0.5714285714,1,0,14,0.8591549296,1,0.9285714286,0.985915493,14,14,14,14,0,0,0,0,2,1,1,71,71,71,71,0,1
386,407,22,22,1,1,0,22,1,1,1,1,22,22,22,22,0,0,0,0,2,1,1,154,154,154,154,0,1
382,447,66,71,0.2676056338,0.7183098592,5,68.5,0.6581196581,0.8170940171,0.0985915493,0.5538461538,71,66,66,71,5,0,0,0,2,1,1,585,581,581,585,4,1
217,226,10,10,1,1,0,10,1,1,1,1,9,9,9,9,0,4,4,8,4,2,2,65,65,65,65,0,1
48,157,110,110,1,1,0,110,1,1,1,1,115,115,115,115,0,0,0,0,2,1,1,685,685,685,685,0,1
1208,1217,10,10,1,1,0,10,1,1,1,1,10,10,10,10,0,0,0,0,2,1,1,61,61,61,61,0,1
48,62,15,15,1,1,0,15,1,1,1,1,16,16,16,16,0,0,0,0,2,1,1,119,119,119,119,0,1
113,124,12,12,1,1,0,12,1,1,1,1,12,12,12,12,0,0,0,0,2,1,1,67,67,67,67,0,1
315,326,12,13,0.7333333333,0.7333333333,1,12.5,0.7520661157,0.7520661157,0.3333333333,0.6115702479,15,14,14,15,1,0,0,0,2,1,1,121,91,91,121,30,1
72,82,9,11,0.2727272727,0.2727272727,2,10,0.3181818182,0.5151515152,0.2727272727,0.3636363636,10,11,10,11,1,0,0,0,2,1,1,59,66,59,66,7,0
49,57,6,9,0.4444444444,0.6666666667,3,7.5,0.4222222222,0.4666666667,0.3333333333,0.4,6,9,6,9,3,0,0,0,4,2,2,21,45,21,45,24,0
249,280,11,32,0.0625,0.125,21,21.5,0.2142857143,0.3655462185,0.0625,0.2394957983,11,32,11,32,21,0,0,0,2,1,1,104,238,104,238,134,0
162,202,41,41,0.7608695652,1,0,41,0.9722921914,1,1,1,46,46,46,46,0,1,1,2,2,1,1,397,397,397,397,0,0
194,203,10,10,1,1,0,10,1,1,1,1,8,8,8,8,0,0,0,0,2,1,1,59,59,59,59,0,1
99,108,10,10,0.3,0.7,0,10,0.4743589744,0.7307692308,0.3,0.5641025641,10,10,10,10,0,0,0,0,2,1,1,62,78,62,78,16,0
945,954,10,10,1,1,0,10,1,1,1,1,9,9,9,9,0,1,1,2,2,1,1,84,84,84,84,0,0
314,323,9,10,0.2,0.2,1,9.5,0.2580645161,0.3978494624,0.2,0.3225806452,10,10,10,10,0,0,0,0,2,1,1,93,59,59,93,34,0
546,568,21,23,0.84,0.88,2,22,0.8395721925,0.871657754,0.68,0.807486631,23,25,23,25,2,0,0,0,2,1,1,166,187,166,187,21,1
316,325,10,10,1,1,0,10,1,1,1,1,10,10,10,10,0,0,0,0,2,1,1,115,115,115,115,0,0
521,534,14,20,0.1904761905,0.2380952381,6,17,0.3450704225,0.5070422535,0.1904761905,0.3661971831,21,14,14,21,7,0,0,0,2,1,1,142,84,84,142,58,0
339,627,289,316,1,1,27,302.5,1,1,1,1,169,169,169,169,0,0,0,0,4,2,2,1487,1487,1487,1487,0,0
92,108,17,17,0.8823529412,0.8823529412,0,17,0.9308176101,0.9308176101,0.0588235294,0.6855345912,17,17,17,17,0,2,2,4,2,1,1,155,159,155,159,4,1
548,570,23,23,0.88,1,0,23,0.9786096257,1,1,1,25,25,25,25,0,0,0,0,2,1,1,187,187,187,187,0,1
296,313,18,18,0.3333333333,0.8333333333,0,18,0.6082474227,0.8453608247,0.2222222222,0.5360824742,18,18,18,18,0,0,0,0,2,1,1,194,185,185,194,9,1
316,324,9,9,1,1,0,9,1,1,1,1,9,9,9,9,0,0,0,0,2,1,1,112,112,112,112,0,1
159,168,8,10,0,0,2,9,0.3538461538,0.6,0,0.4923076923,8,10,8,10,2,0,2,2,2,1,1,65,65,65,65,0,0
81,111,17,31,0.3076923077,0.9230769231,14,24,0.75,0.9821428571,0.9230769231,0.9821428571,13,13,13,13,0,1,1,2,4,2,2,56,56,56,56,0,0
437,530,94,94,0.9784946237,1,0,94,0.9974683544,1,0.9892473118,0.9987341772,93,93,93,93,0,0,0,0,4,2,2,790,790,790,790,0,1
463,483,11,21,0.1428571429,0.2380952381,10,16,0.3706896552,0.5603448276,0.1428571429,0.4224137931,11,21,11,21,10,0,0,0,3,2,1,88,116,88,116,28,0
536,547,12,12,1,1,0,12,1,1,1,1,13,13,13,13,0,0,0,0,2,1,1,104,104,104,104,0,1
977,986,10,22,0.0909090909,0.1818181818,12,16,0.3175675676,0.5202702703,0.0909090909,0.3986486486,22,10,10,22,12,0,0,0,3,1,2,148,95,95,148,53,0
209,217,9,9,0.7,0.7,0,9,0.8701298701,0.8701298701,0.1,0.6363636364,10,10,10,10,0,0,1,1,2,1,1,77,77,77,77,0,1
558,596,39,39,1,1,0,39,1,1,1,1,27,27,27,27,0,0,0,0,4,2,2,193,193,193,193,0,0
74,106,33,33,1,1,0,33,1,1,1,1,17,17,17,17,0,0,0,0,0,0,0,113,113,113,113,0,1
555,569,13,15,0.2666666667,0.5333333333,2,14,0.6352941176,0.7882352941,0.3333333333,0.6941176471,14,15,14,15,1,0,0,0,2,1,1,85,85,85,85,0,0
135,182,48,48,1,1,0,48,1,1,1,1,48,48,48,48,0,0,0,0,2,1,1,318,318,318,318,0,1
6,18,13,13,1,1,0,13,1,1,1,1,13,13,13,13,0,0,0,0,2,1,1,138,138,138,138,0,1
203,219,17,17,0.3076923077,0.7692307692,0,17,0.6507936508,0.9047619048,0.3076923077,0.619047619,13,13,13,13,0,0,0,0,4,2,2,63,63,63,63,0,0
64,66,3,3,0,0.6666666667,0,3,0.7833333333,0.9333333333,0.6666666667,0.9333333333,3,3,3,3,0,0,0,0,2,1,1,56,60,56,60,4,1
39,50,12,13,0.3846153846,0.7692307692,1,12.5,0.5352112676,0.7605633803,0.3846153846,0.5633802817,13,12,12,13,1,0,0,0,3,2,1,71,58,58,71,13,0
126,138,13,13,1,1,0,13,1,1,1,1,13,13,13,13,0,0,0,0,2,1,1,111,111,111,111,0,1
308,323,16,16,1,1,0,16,1,1,1,1,17,17,17,17,0,0,0,0,2,1,1,108,108,108,108,0,1
185,196,9,12,0.1818181818,0.1818181818,3,10.5,0.3333333333,0.5641025641,0.1818181818,0.358974359,8,11,8,11,3,1,1,2,4,2,2,78,77,77,78,1,0
56,65,10,10,1,1,0,10,1,1,1,1,10,10,10,10,0,1,1,2,2,1,1,77,77,77,77,0,1
506,524,19,19,1,1,0,19,1,1,1,1,20,20,20,20,0,0,0,0,2,1,1,235,235,235,235,0,1
69,89,17,21,0.7619047619,0.7619047619,4,19,0.8175675676,0.8378378378,0.5714285714,0.7972972973,17,21,17,21,4,0,0,0,2,1,1,125,148,125,148,23,1
279,291,13,13,0.625,0.9375,0,13,0.8211382114,0.8943089431,0.9375,0.8943089431,16,16,16,16,0,0,1,1,2,1,1,123,111,111,123,12,1
510,516,7,7,0.2857142857,0.7142857143,0,7,0.6282051282,0.7435897436,0.7142857143,0.7307692308,7,7,7,7,0,1,0,1,2,1,1,78,62,62,78,16,1
474,505,32,32,1,1,0,32,1,1,1,1,32,32,32,32,0,0,0,0,2,1,1,224,224,224,224,0,0
49,51,3,3,0,0.6666666667,0,3,0.7833333333,0.9333333333,0.6666666667,0.9333333333,3,3,3,3,0,0,0,0,2,1,1,60,56,56,60,4,0
776,787,12,14,0.4285714286,0.7857142857,2,13,0.6834532374,0.7769784173,0.2857142857,0.6474820144,14,12,12,14,2,0,0,0,2,1,1,139,108,108,139,31,0
90,104,15,18,0.1111111111,0.6111111111,3,16.5,0.5637583893,0.7315436242,0.1111111111,0.4966442953,18,15,15,18,3,0,0,0,2,1,1,149,111,111,149,38,1
95,98,4,6,0.1428571429,0.2857142857,2,5,0.4558823529,0.6323529412,0.2857142857,0.5588235294,7,5,5,7,2,1,1,2,2,1,1,68,47,47,68,21,0
105,116,12,12,1,1,0,12,1,1,1,1,12,12,12,12,0,0,0,0,2,1,1,106,106,106,106,0,1
322,360,39,39,1,1,0,39,1,1,1,1,39,39,39,39,0,0,0,0,2,1,1,296,296,296,296,0,1
632,649,16,18,0.3333333333,0.8888888889,2,17,0.8162162162,0.9243243243,0.6666666667,0.8918918919,16,18,16,18,2,0,0,0,2,1,1,171,185,171,185,14,1
92,99,8,8,0.875,1,0,8,0.9705882353,1,1,1,8,8,8,8,0,1,1,2,2,1,1,68,68,68,68,0,1
871,890,19,20,0.7,0.8,1,19.5,0.7161290323,0.7612903226,0.3,0.6064516129,19,20,19,20,1,0,0,0,2,1,1,155,132,132,155,23,1
662,676,15,15,0.8666666667,1,0,15,0.9856115108,1,1,1,15,15,15,15,0,1,1,2,2,1,1,139,139,139,139,0,1
66,72,7,7,0.625,0.875,0,7,0.8481012658,0.8987341772,0.25,0.6455696203,8,8,8,8,0,0,0,0,2,1,1,79,71,71,79,8,1
493,502,10,10,0.9,0.9,0,10,0.98,0.98,0.9,0.98,10,10,10,10,0,0,0,0,2,1,1,50,50,50,50,0,1
716,725,10,10,0.6666666667,0.8333333333,0,10,0.8666666667,0.9333333333,0.8333333333,0.9111111111,12,12,12,12,0,0,0,0,2,1,1,90,89,89,90,1,0
130,134,5,5,1,1,0,5,1,1,1,1,6,6,6,6,0,2,2,4,2,1,1,69,69,69,69,0,1
21,38,13,18,0.1666666667,0.3333333333,5,15.5,0.3897058824,0.5441176471,0.1666666667,0.4191176471,13,18,13,18,5,0,0,0,2,1,1,78,136,78,136,58,0
39,44,6,7,0.2857142857,0.7142857143,1,6.5,0.5,0.7083333333,0.1428571429,0.5416666667,7,6,6,7,1,0,0,0,2,1,1,48,36,36,48,12,0
267,283,16,17,0.6470588235,0.7058823529,1,16.5,0.69,0.75,0.2352941176,0.57,16,17,16,17,1,0,0,0,2,1,1,84,100,84,100,16,0
35,59,25,25,0,1,0,25,0.8148148148,1,1,1,25,25,25,25,0,0,0,0,2,1,1,135,135,135,135,0,0
394,404,11,11,1,1,0,11,1,1,1,1,12,12,12,12,0,0,0,0,2,1,1,159,159,159,159,0,1
404,414,11,11,0.8333333333,0.8333333333,0,11,0.9411764706,0.9411764706,0.8333333333,0.9411764706,12,12,12,12,0,0,0,0,2,1,1,68,65,65,68,3,1
24,47,24,24,1,1,0,24,1,1,1,1,18,18,18,18,0,1,1,2,2,1,1,116,116,116,116,0,1
133,142,10,15,0.1333333333,0.1333333333,5,12.5,0.3421052632,0.5614035088,0.1333333333,0.4298245614,15,10,10,15,5,0,0,0,2,1,1,114,88,88,114,26,0
197,213,17,17,1,1,0,17,1,1,1,1,17,17,17,17,0,0,0,0,2,1,1,227,227,227,227,0,1
246,252,7,7,0.7142857143,1,0,7,0.9545454545,1,0.7142857143,0.9242424242,7,7,7,7,0,0,0,0,2,1,1,66,66,66,66,0,1
561,568,8,8,0.8888888889,1,0,8,0.9807692308,1,1,1,9,9,9,9,0,1,1,2,2,1,1,52,52,52,52,0,1
209,231,23,24,0.92,0.92,1,23.5,0.94,0.94,0.48,0.76,25,24,24,25,1,0,0,0,2,1,1,150,142,142,150,8,1
1167,1195,29,29,0.3793103448,0.3793103448,0,29,0.7303370787,0.7303370787,0.3448275862,0.5842696629,29,29,29,29,0,0,0,0,2,1,1,267,195,195,267,72,1
1524,1530,7,7,0.8333333333,1,0,7,0.9814814815,1,1,1,6,6,6,6,0,1,1,2,2,1,1,54,54,54,54,0,1
26,33,8,8,0.375,1,0,8,0.9154929577,1,1,1,8,8,8,8,0,0,0,0,2,1,1,71,71,71,71,0,1
243,252,10,10,1,1,0,10,1,1,1,1,10,10,10,10,0,0,0,0,2,1,1,90,90,90,90,0,1
270,287,18,18,1,1,0,18,1,1,1,1,18,18,18,18,0,1,1,2,2,1,1,278,278,278,278,0,1
1142,1147,6,6,1,1,0,6,1,1,1,1,6,6,6,6,0,0,0,0,2,1,1,31,31,31,31,0,1
21,26,6,6,1,1,0,6,1,1,1,1,8,8,8,8,0,2,2,4,2,1,1,95,95,95,95,0,1
105,136,32,32,1,1,0,32,1,1,1,1,25,25,25,25,0,2,2,4,4,2,2,175,175,175,175,0,1
457,465,9,9,0.8181818182,0.9090909091,0,9,0.9102564103,0.9487179487,0.8181818182,0.9358974359,11,11,11,11,0,0,0,0,2,1,1,75,78,75,78,3,1
1407,1417,11,11,0.6363636364,1,0,11,0.8260869565,1,1,1,11,11,11,11,0,0,0,0,2,1,1,46,46,46,46,0,1
149,170,22,22,1,1,0,22,1,1,1,1,22,22,22,22,0,0,0,0,2,1,1,112,112,112,112,0,1
1400,1428,29,29,0.9655172414,1,0,29,0.9948717949,1,1,1,29,29,29,29,0,0,0,0,2,1,1,195,195,195,195,0,1
738,765,26,28,0.5357142857,0.7142857143,2,27,0.8341968912,0.9170984456,0.5714285714,0.8393782383,26,28,26,28,2,0,0,0,2,1,1,183,193,183,193,10,1
258,272,15,15,0.5882352941,0.9411764706,0,15,0.8848484848,0.9515151515,0.2352941176,0.6606060606,17,17,17,17,0,0,0,0,2,1,1,157,165,157,165,8,1
660,676,17,17,1,1,0,17,1,1,1,1,17,17,17,17,0,0,0,0,2,1,1,103,103,103,103,0,1
108,122,15,15,0.6470588235,0.9411764706,0,15,0.9044585987,0.949044586,0.8823529412,0.9299363057,17,17,17,17,0,0,0,0,2,1,1,149,157,149,157,8,1
583,590,8,8,0.8888888889,1,0,8,0.9807692308,1,1,1,9,9,9,9,0,1,1,2,2,1,1,52,52,52,52,0,1
629,646,18,18,0.9,1,0,18,0.9854014599,1,1,1,20,20,20,20,0,0,0,0,2,1,1,137,137,137,137,0,1
417,421,5,5,0,0.8,0,5,0.8727272727,0.9818181818,0.4,0.9272727273,5,5,5,5,0,0,0,0,2,1,1,55,54,54,55,1,1
432,445,14,14,1,1,0,14,1,1,1,1,15,15,15,15,0,2,2,4,2,1,1,126,126,126,126,0,1
73,89,17,17,1,1,0,17,1,1,1,1,20,20,20,20,0,0,0,0,4,2,2,158,158,158,158,0,1
48,62,15,15,1,1,0,15,1,1,1,1,16,16,16,16,0,0,0,0,2,1,1,119,119,119,119,0,1
742,747,6,6,0.6666666667,1,0,6,0.9393939394,1,1,1,6,6,6,6,0,0,0,0,2,1,1,33,33,33,33,0,1
956,962,7,7,0.625,0.75,0,7,0.9107142857,0.9464285714,0.75,0.9464285714,8,8,8,8,0,0,0,0,2,1,1,56,56,56,56,0,1
80,85,6,6,0.8571428571,1,0,6,0.9830508475,1,1,1,7,7,7,7,0,1,1,2,2,1,1,59,59,59,59,0,1
42,48,7,7,0.8888888889,1,0,7,0.9905660377,1,1,1,9,9,9,9,0,3,3,6,2,1,1,106,106,106,106,0,1
183,197,15,15,1,1,0,15,1,1,1,1,16,16,16,16,0,0,0,0,2,1,1,119,119,119,119,0,1
340,371,32,32,1,1,0,32,1,1,1,1,32,32,32,32,0,0,0,0,2,1,1,398,398,398,398,0,1
751,758,8,8,1,1,0,8,1,1,1,1,10,10,10,10,0,1,1,2,2,1,1,75,75,75,75,0,1
629,648,20,20,0.8571428571,1,0,20,0.9806451613,1,1,1,21,21,21,21,0,1,1,2,4,2,2,155,155,155,155,0,1
415,445,31,31,1,1,0,31,1,1,1,1,32,32,32,32,0,1,1,2,2,1,1,294,294,294,294,0,1
763,786,24,24,0.92,0.92,0,24,0.9488054608,0.9590443686,0.28,0.8805460751,25,25,25,25,0,0,0,0,2,1,1,293,283,283,293,10,1
343,367,25,25,1,1,0,25,1,1,1,1,16,16,16,16,0,0,0,0,4,2,2,106,106,106,106,0,1
69,76,8,8,0.875,0.875,0,8,0.9113924051,0.9240506329,0.875,0.9240506329,8,8,8,8,0,3,3,6,2,1,1,79,73,73,79,6,1
197,206,10,11,0.3636363636,0.4545454545,1,10.5,0.4117647059,0.6617647059,0.3636363636,0.5147058824,11,10,10,11,1,0,0,0,2,1,1,68,63,63,68,5,0
463,480,18,18,0.8888888889,0.9444444444,0,18,0.8834951456,0.8932038835,0.9444444444,0.8932038835,18,18,18,18,0,0,1,1,4,2,2,103,93,93,103,10,1
76,84,9,9,0.7,1,0,9,0.9655172414,1,1,1,10,10,10,10,0,1,1,2,2,1,1,87,87,87,87,0,1
940,952,12,13,0.6153846154,0.9230769231,1,12.5,0.8595041322,0.8925619835,0.6923076923,0.8760330579,12,13,12,13,1,0,0,0,2,1,1,108,121,108,121,13,1
648,665,18,23,0.68,0.72,5,20.5,0.7165775401,0.7326203209,0.32,0.5989304813,25,20,20,25,5,0,0,0,2,1,1,187,137,137,187,50,1
41,101,61,61,0,0,0,61,0.0040322581,0.3709677419,0,0.25,31,31,31,31,0,0,0,0,0,0,0,124,248,124,248,124,0
192,218,27,27,1,1,0,27,1,1,1,1,27,27,27,27,0,0,0,0,2,1,1,223,223,223,223,0,1
422,428,7,7,0.8571428571,0.8571428571,0,7,0.9154929577,0.9295774648,0,0.7676056338,7,7,7,7,0,0,0,0,2,1,1,142,132,132,142,10,0
69,76,8,8,0.4285714286,0.7142857143,0,8,0.8552631579,0.9473684211,0.5714285714,0.8815789474,7,7,7,7,0,2,2,4,2,1,1,76,72,72,76,4,1
1110,1122,13,13,1,1,0,13,1,1,1,1,13,13,13,13,0,0,0,0,2,1,1,67,67,67,67,0,1
686,711,26,26,1,1,0,26,1,1,1,1,26,26,26,26,0,0,0,0,2,1,1,297,297,297,297,0,1
174,188,15,15,1,1,0,15,1,1,1,1,15,15,15,15,0,0,0,0,2,1,1,206,206,206,206,0,1
522,540,19,19,1,1,0,19,1,1,1,1,20,20,20,20,0,0,0,0,2,1,1,235,235,235,235,0,1
50,61,12,12,1,1,0,12,1,1,1,1,12,12,12,12,0,0,0,0,2,1,1,83,83,83,83,0,1
599,617,19,22,0.6363636364,0.8636363636,3,20.5,0.7411764706,0.7941176471,0.4090909091,0.6764705882,22,19,19,22,3,0,0,0,2,1,1,170,135,135,170,35,1
34,49,16,16,1,1,0,16,1,1,1,1,17,17,17,17,0,0,0,0,2,1,1,135,135,135,135,0,1
178,183,6,6,0.7142857143,0.8571428571,0,6,0.8405797101,0.884057971,0.2857142857,0.6231884058,7,7,7,7,0,1,1,2,2,1,1,69,61,61,69,8,1
26,34,9,9,1,1,0,9,1,1,1,1,9,9,9,9,0,1,1,2,0,0,0,53,53,53,53,0,1
498,504,7,12,0.1818181818,0.2727272727,5,9.5,0.447761194,0.6119402985,0.1818181818,0.4626865672,11,7,7,11,4,0,0,0,3,2,1,67,58,58,67,9,0
99,111,13,13,1,1,0,13,1,1,1,1,13,13,13,13,0,0,0,0,2,1,1,117,117,117,117,0,1
522,544,23,23,1,1,0,23,1,1,1,1,25,25,25,25,0,0,0,0,2,1,1,187,187,187,187,0,1
225,234,10,10,0.1,0.1,0,10,0.3536585366,0.5975609756,0.1,0.4512195122,10,10,10,10,0,0,0,0,2,1,1,72,82,72,82,10,0
146,151,6,6,0.7142857143,0.8571428571,0,6,0.8405797101,0.884057971,0.2857142857,0.6231884058,7,7,7,7,0,1,1,2,2,1,1,61,69,61,69,8,1
211,231,21,21,0.9166666667,1,0,21,0.98,1,0.9166666667,0.98,24,24,24,24,0,0,0,0,2,1,1,200,200,200,200,0,1
388,399,11,12,0.6666666667,0.6666666667,1,11.5,0.9130434783,0.9130434783,0.1666666667,0.5652173913,11,12,11,12,1,2,2,4,2,1,1,69,64,64,69,5,1
925,937,12,13,0.6153846154,0.9230769231,1,12.5,0.867768595,0.9421487603,0.3076923077,0.7603305785,12,13,12,13,1,0,0,0,2,1,1,114,121,114,121,7,1
162,176,15,15,0.5882352941,0.8823529412,0,15,0.8679245283,0.9371069182,0.2352941176,0.6352201258,17,17,17,17,0,1,0,1,2,1,1,159,157,157,159,2,0
146,159,14,14,0.7857142857,0.8571428571,0,14,0.9361702128,0.9468085106,0.8571428571,0.9468085106,14,14,14,14,0,0,0,0,2,1,1,94,90,90,94,4,1
32,51,20,20,1,1,0,20,1,1,1,1,20,20,20,20,0,0,0,0,2,1,1,133,133,133,133,0,1
198,216,19,19,1,1,0,19,1,1,1,1,21,21,21,21,0,1,1,2,2,1,1,169,169,169,169,0,1
423,454,32,32,1,1,0,32,1,1,1,1,32,32,32,32,0,0,0,0,2,1,1,224,224,224,224,0,0
349,379,31,31,1,1,0,31,1,1,1,1,31,31,31,31,0,0,0,0,2,1,1,393,393,393,393,0,1
105,112,8,8,0.375,0.75,0,8,0.4893617021,0.7021276596,0.5,0.5744680851,8,8,8,8,0,0,0,0,2,1,1,35,47,35,47,12,0
364,381,18,18,0,1,0,18,0.8571428571,1,1,1,18,18,18,18,0,0,0,0,2,1,1,126,126,126,126,0,0
24,66,43,43,1,1,0,43,1,1,1,1,38,38,38,38,0,2,2,4,2,1,1,274,274,274,274,0,1
944,957,12,14,0.8571428571,0.8571428571,2,13,0.9655172414,0.9655172414,0.8571428571,0.9655172414,12,14,12,14,2,3,1,4,2,1,1,56,58,56,58,2,1
220,231,12,13,0.5384615385,0.8461538462,1,12.5,0.7933884298,0.9256198347,0.3076923077,0.7272727273,13,12,12,13,1,0,0,0,2,1,1,121,118,118,121,3,0
401,425,25,25,0.5357142857,0.8928571429,0,25,0.8764478764,0.9305019305,0.4285714286,0.7065637066,28,28,28,28,0,1,1,2,2,1,1,259,243,243,259,16,1
75,81,7,7,0.4285714286,0.7142857143,0,7,0.5151515152,0.6666666667,0.4285714286,0.5454545455,7,7,7,7,0,0,0,0,2,1,1,33,25,25,33,8,0
68,76,9,9,0.7,1,0,9,0.9659090909,1,1,1,10,10,10,10,0,1,1,2,2,1,1,88,88,88,88,0,1
208,241,34,34,1,1,0,34,1,1,1,1,35,35,35,35,0,0,0,0,2,1,1,387,387,387,387,0,1
926,941,16,16,1,1,0,16,1,1,1,1,16,16,16,16,0,1,1,2,2,1,1,116,116,116,116,0,1
459,468,10,10,0.5,0.7,0,10,0.6603773585,0.8301886792,0.4,0.679245283,10,10,10,10,0,0,0,0,2,1,1,53,53,53,53,0,1
545,564,20,20,0.9523809524,0.9523809524,0,20,0.9912280702,0.9912280702,0.9523809524,0.9912280702,21,21,21,21,0,0,0,0,2,1,1,114,114,114,114,0,1
142,158,17,17,0.5263157895,0.8947368421,0,17,0.8901734104,0.9421965318,0.4210526316,0.710982659,19,19,19,19,0,1,1,2,2,1,1,173,165,165,173,8,0
610,621,12,12,0.0833333333,0.3333333333,0,12,0.3854166667,0.59375,0.0833333333,0.4270833333,12,12,12,12,0,0,0,0,2,1,1,66,96,66,96,30,0
3,10,8,8,0.375,1,0,8,0.8928571429,1,0.625,0.9285714286,8,8,8,8,0,0,0,0,0,0,0,56,56,56,56,0,0
681,687,7,8,0.5,0.625,1,7.5,0.7260273973,0.8082191781,0.25,0.6301369863,8,7,7,8,1,0,0,0,2,1,1,73,69,69,73,4,1
25,35,11,11,0,0,0,11,0.3958333333,0.6875,0,0.4583333333,6,6,6,6,0,0,0,0,0,0,0,48,36,36,48,12,0
650,669,20,20,0.8571428571,1,0,20,0.9806451613,1,1,1,21,21,21,21,0,1,1,2,4,2,2,155,155,155,155,0,1
231,247,17,17,1,1,0,17,1,1,1,1,19,19,19,19,0,0,0,0,2,1,1,185,185,185,185,0,1
251,268,18,19,0.3157894737,0.9473684211,1,18.5,0.859375,0.9635416667,0.7368421053,0.9322916667,19,18,18,19,1,0,0,0,2,1,1,192,185,185,192,7,1
1032,1045,14,14,0.5,0.7142857143,0,14,0.7766990291,0.8640776699,0.5,0.6796116505,14,14,14,14,0,0,0,0,2,1,1,103,101,101,103,2,0
108,113,6,6,0.7142857143,1,0,6,0.9565217391,1,1,1,7,7,7,7,0,1,1,2,2,1,1,69,69,69,69,0,1
220,231,12,12,0.5833333333,0.9166666667,0,12,0.8559322034,0.9406779661,0.3333333333,0.7542372881,12,12,12,12,0,0,0,0,2,1,1,114,118,114,118,4,1
561,582,22,22,1,1,0,22,1,1,1,1,22,22,22,22,0,0,0,0,2,1,1,154,154,154,154,0,0
1,9,9,9,0.5,0.75,0,9,0.7931034483,0.8965517241,0,0.5689655172,8,8,8,8,0,0,0,0,0,0,0,52,58,52,58,6,1
570,600,31,31,0.96875,0.96875,0,31,0.982078853,0.9856630824,0.96875,0.9856630824,32,32,32,32,0,0,0,0,2,1,1,279,275,275,279,4,1
297,306,10,10,1,1,0,10,1,1,1,1,10,10,10,10,0,0,0,0,2,1,1,77,77,77,77,0,1
65,71,7,7,0.5714285714,0.7142857143,0,7,0.7037037037,0.7777777778,0.7142857143,0.7777777778,7,7,7,7,0,0,0,0,2,1,1,26,27,26,27,1,0
404,423,17,20,0.2857142857,0.4761904762,3,18.5,0.7631578947,0.8289473684,0.2857142857,0.6381578947,18,21,18,21,3,0,0,0,2,1,1,152,152,152,152,0,1
886,897,12,14,0.4666666667,0.4666666667,2,13,0.8076923077,0.8141025641,0.2666666667,0.6987179487,15,13,13,15,2,0,0,0,2,1,1,151,156,151,156,5,1
55,61,7,7,0.625,0.875,0,7,0.8421052632,0.8947368421,0.375,0.6578947368,8,8,8,8,0,1,1,2,2,1,1,76,68,68,76,8,0
164,170,7,7,0.1428571429,0.1428571429,0,7,0.3571428571,0.6,0.1428571429,0.4,7,7,7,7,0,1,1,2,2,1,1,67,70,67,70,3,0
452,473,22,22,0,0,0,22,0.3636363636,0.5454545455,0,0.5454545455,22,22,22,22,0,0,0,0,2,1,1,242,154,154,242,88,0
82,91,10,10,1,1,0,10,1,1,1,1,10,10,10,10,0,0,0,0,2,1,1,104,104,104,104,0,1
110,197,88,88,1,1,0,88,1,1,1,1,88,88,88,88,0,0,0,0,2,1,1,484,484,484,484,0,1
113,124,12,12,1,1,0,12,1,1,1,1,12,12,12,12,0,0,0,0,2,1,1,67,67,67,67,0,1
59,81,23,23,1,1,0,23,1,1,1,1,23,23,23,23,0,2,2,4,2,1,1,141,141,141,141,0,1
73,82,8,10,0.6,0.7,2,9,0.9032258065,0.9193548387,0.7,0.9193548387,9,10,9,10,1,0,0,0,2,1,1,62,62,62,62,0,1
407,422,16,16,0.6875,0.9375,0,16,0.8944099379,0.9378881988,0.3125,0.7639751553,16,16,16,16,0,0,0,0,2,1,1,161,155,155,161,6,1
48,58,9,11,0.3333333333,0.4166666667,2,10,0.4864864865,0.6756756757,0.3333333333,0.5405405405,10,12,10,12,2,0,0,0,2,1,1,74,73,73,74,1,0
604,617,14,14,1,1,0,14,1,1,1,1,15,15,15,15,0,0,0,0,2,1,1,131,131,131,131,0,1
328,352,25,25,0.84,1,0,25,0.8928571429,1,0.16,0.7295918367,25,25,25,25,0,1,1,2,2,1,1,392,392,392,392,0,1
208,241,34,34,1,1,0,34,1,1,1,1,35,35,35,35,0,0,0,0,2,1,1,387,387,387,387,0,1
623,663,41,41,1,1,0,41,1,1,1,1,44,44,44,44,0,0,0,0,2,1,1,315,315,315,315,0,1
624,641,18,23,0.68,0.72,5,20.5,0.7165775401,0.7326203209,0.32,0.5989304813,25,20,20,25,5,0,0,0,2,1,1,187,137,137,187,50,1
1819,1828,10,10,0.3,0.7,0,10,0.4561403509,0.6842105263,0.4,0.5614035088,10,10,10,10,0,0,0,0,2,1,1,57,49,49,57,8,0
207,219,13,13,1,1,0,13,1,1,1,1,15,15,15,15,0,2,2,4,2,1,1,133,133,133,133,0,0
20,70,51,62,0.6923076923,0.7230769231,11,56.5,0.8497409326,0.8618307427,0.2,0.6286701209,65,56,56,65,9,0,0,0,2,1,1,579,536,536,579,43,1
689,713,25,25,1,1,0,25,1,1,1,1,25,25,25,25,0,1,1,2,2,1,1,214,214,214,214,0,1
333,355,23,23,0.9565217391,0.9565217391,0,23,0.9788135593,0.9788135593,0.9565217391,0.9788135593,23,23,23,23,0,0,0,0,2,1,1,236,231,231,236,5,1
126,139,14,14,0.875,0.9375,0,14,0.952,0.968,0.8125,0.928,16,16,16,16,0,0,0,0,2,1,1,121,125,121,125,4,1
698,707,10,11,0.3636363636,0.7272727273,1,10.5,0.6629213483,0.7415730337,0.6363636364,0.7191011236,11,10,10,11,1,0,0,0,2,1,1,89,68,68,89,21,1
295,307,12,13,0.7333333333,0.7333333333,1,12.5,0.7520661157,0.7520661157,0.3333333333,0.6115702479,14,15,14,15,1,0,0,0,2,1,1,91,121,91,121,30,1
10,10,1,1,1,1,0,1,1,1,1,1,1,1,1,1,0,0,0,0,0,0,0,2099,2099,2099,2099,0,0
81,94,14,14,1,1,0,14,1,1,1,1,14,14,14,14,0,0,0,0,2,1,1,91,91,91,91,0,1
1513,1527,15,15,1,1,0,15,1,1,1,1,15,15,15,15,0,0,0,0,2,1,1,104,104,104,104,0,1
570,590,18,21,0.7391304348,0.7826086957,3,19.5,0.7951807229,0.813253012,0.347826087,0.656626506,20,23,20,23,3,0,0,0,2,1,1,137,166,137,166,29,1
63,73,11,11,1,1,0,11,1,1,1,1,11,11,11,11,0,2,2,4,2,1,1,114,114,114,114,0,1
126,137,12,12,0.75,0.8333333333,0,12,0.7887323944,0.8169014085,0.1666666667,0.5985915493,12,12,12,12,0,0,0,0,2,1,1,142,116,116,142,26,1
233,247,15,15,1,1,0,15,1,1,1,1,15,15,15,15,0,0,0,0,2,1,1,140,140,140,140,0,1
234,245,12,15,0.4,0.7333333333,3,13.5,0.6838709677,0.7612903226,0.2666666667,0.6322580645,15,12,12,15,3,0,0,0,2,1,1,155,118,118,155,37,1
110,197,88,88,1,1,0,88,1,1,1,1,88,88,88,88,0,0,0,0,2,1,1,484,484,484,484,0,1
538,567,30,30,0.8333333333,0.9583333333,0,30,0.9597701149,0.9942528736,0.9583333333,0.9942528736,24,24,24,24,0,0,0,0,4,2,2,174,174,174,174,0,0
209,223,15,15,1,1,0,15,1,1,1,1,13,13,13,13,0,3,3,6,6,3,3,109,109,109,109,0,1
308,329,22,22,1,1,0,22,1,1,1,1,22,22,22,22,0,0,0,0,2,1,1,154,154,154,154,0,1
479,498,18,20,0.3,0.9,2,19,0.8291457286,0.9296482412,0.7,0.8994974874,18,20,18,20,2,0,0,0,2,1,1,185,199,185,199,14,1
51,51,1,1,0,1,0,1,0.8151515152,1,1,1,1,1,1,1,0,0,0,0,0,0,0,330,330,330,330,0,1
99,111,13,13,1,1,0,13,1,1,1,1,13,13,13,13,0,0,0,0,2,1,1,117,117,117,117,0,1
474,483,10,10,1,1,0,10,1,1,1,1,11,11,11,11,0,0,0,0,2,1,1,78,78,78,78,0,1
349,352,4,4,0.6666666667,1,0,4,0.9743589744,1,1,1,6,6,6,6,0,0,0,0,2,1,1,78,78,78,78,0,1
195,201,7,7,0.5714285714,0.7142857143,0,7,0.8421052632,0.8947368421,0.2857142857,0.7631578947,7,7,7,7,0,0,0,0,2,1,1,68,76,68,76,8,1
629,646,18,18,1,1,0,18,1,1,1,1,20,20,20,20,0,0,0,0,2,1,1,137,137,137,137,0,1
680,706,27,27,1,1,0,27,1,1,1,1,27,27,27,27,0,0,0,0,2,1,1,158,158,158,158,0,1
113,132,20,20,0.8,1,0,20,0.9763313609,1,1,1,20,20,20,20,0,1,1,2,2,1,1,169,169,169,169,0,1
687,703,17,17,1,1,0,17,1,1,1,1,17,17,17,17,0,0,0,0,2,1,1,84,84,84,84,0,1
459,472,13,14,0.7142857143,0.7857142857,1,13.5,0.8796992481,0.9172932331,0.5714285714,0.7969924812,13,14,13,14,1,0,0,0,2,1,1,133,128,128,133,5,1
185,333,149,149,1,1,0,149,1,1,1,1,61,61,61,61,0,1,1,2,4,2,2,603,603,603,603,0,1
1168,1192,25,25,1,1,0,25,1,1,1,1,25,25,25,25,0,3,3,6,2,1,1,181,181,181,181,0,1
470,500,31,31,1,1,0,31,1,1,1,1,31,31,31,31,0,0,0,0,2,1,1,217,217,217,217,0,1
1,9,9,9,0.375,0.75,0,9,0.7931034483,0.8965517241,0,0.5517241379,8,8,8,8,0,0,0,0,0,0,0,58,52,52,58,6,0
340,350,11,11,0.9090909091,1,0,11,0.9824561404,1,1,1,11,11,11,11,0,0,0,0,2,1,1,57,57,57,57,0,1
963,975,13,13,1,1,0,13,1,1,1,1,13,13,13,13,0,0,0,0,2,1,1,94,94,94,94,0,1
14,76,63,63,1,1,0,63,1,1,1,1,63,63,63,63,0,0,0,0,2,1,1,729,729,729,729,0,1
126,138,13,13,1,1,0,13,1,1,1,1,13,13,13,13,0,0,0,0,2,1,1,111,111,111,111,0,1
158,174,16,17,0.6470588235,0.8235294118,1,16.5,0.7735849057,0.8553459119,0.2941176471,0.6163522013,16,17,16,17,1,0,0,0,4,2,2,144,159,144,159,15,1
522,544,21,23,0.84,0.88,2,22,0.8395721925,0.871657754,0.68,0.807486631,23,25,23,25,2,0,0,0,2,1,1,166,187,166,187,21,1
10,34,25,25,0.9565217391,1,0,25,0.9931972789,1,1,1,23,23,23,23,0,3,3,6,2,1,1,147,147,147,147,0,1
134,140,7,7,0.625,0.875,0,7,0.8481012658,0.8987341772,0.25,0.6455696203,8,8,8,8,0,0,0,0,2,1,1,71,79,71,79,8,1
84,116,33,33,1,1,0,33,1,1,1,1,33,33,33,33,0,0,0,0,2,1,1,273,273,273,273,0,1
1026,1031,6,8,0.25,0.625,2,7,0.5,0.6470588235,0.25,0.5,8,6,6,8,2,0,0,0,2,1,1,34,27,27,34,7,0
196,208,10,13,0.0769230769,0.2307692308,3,11.5,0.3853211009,0.5963302752,0.0769230769,0.4587155963,10,13,10,13,3,0,0,0,2,1,1,100,109,100,109,9,0
687,693,7,7,0.4285714286,0.7142857143,0,7,0.6551724138,0.8275862069,0.4285714286,0.724137931,7,7,7,7,0,0,0,0,2,1,1,27,29,27,29,2,0
402,449,48,48,1,1,0,48,1,1,1,1,48,48,48,48,0,0,0,0,2,1,1,336,336,336,336,0,0
343,364,22,22,1,1,0,22,1,1,1,1,22,22,22,22,0,0,0,0,2,1,1,154,154,154,154,0,1
330,359,30,30,1,1,0,30,1,1,1,1,30,30,30,30,0,0,0,0,2,1,1,252,252,252,252,0,1
138,152,15,15,0.6470588235,0.9411764706,0,15,0.9044585987,0.949044586,0.8823529412,0.9299363057,17,17,17,17,0,0,0,0,2,1,1,149,157,149,157,8,0
92,101,10,10,0.9,1,0,10,0.9836065574,1,1,1,10,10,10,10,0,0,0,0,2,1,1,61,61,61,61,0,1
590,598,9,10,0.5833333333,0.6666666667,1,9.5,0.5813953488,0.6279069767,0.25,0.476744186,12,11,11,12,1,0,0,0,2,1,1,86,64,64,86,22,0
295,307,12,13,0.7333333333,0.7333333333,1,12.5,0.7520661157,0.7520661157,0.3333333333,0.6115702479,14,15,14,15,1,0,0,0,2,1,1,91,121,91,121,30,0
247,257,11,11,1,1,0,11,1,1,1,1,10,10,10,10,0,4,4,8,4,2,2,92,92,92,92,0,0
165,174,10,10,1,1,0,10,1,1,1,1,10,10,10,10,0,0,0,0,2,1,1,96,96,96,96,0,1
467,482,16,21,0.2380952381,0.2857142857,5,18.5,0.3831775701,0.5514018692,0.1904761905,0.4018691589,21,17,17,21,4,0,0,0,3,2,1,96,107,96,107,11,0
122,153,32,32,1,1,0,32,1,1,1,1,33,33,33,33,0,0,0,0,2,1,1,235,235,235,235,0,1
52,106,55,55,1,1,0,55,1,1,1,1,28,28,28,28,0,1,1,2,0,0,0,241,241,241,241,0,0
82,98,17,17,0.6315789474,0.9473684211,0,17,0.9075144509,0.9537572254,0.8421052632,0.9421965318,19,19,19,19,0,1,1,2,2,1,1,173,165,165,173,8,0
629,646,18,21,0.7391304348,0.7826086957,3,19.5,0.7951807229,0.813253012,0.347826087,0.656626506,23,20,20,23,3,0,0,0,2,1,1,166,137,137,166,29,0
351,430,80,80,1,1,0,80,1,1,1,1,80,80,80,80,0,0,0,0,2,1,1,560,560,560,560,0,1
5,12,8,9,0.375,0.875,1,8.5,0.8214285714,0.9107142857,0,0.7142857143,8,8,8,8,0,0,0,0,0,0,0,52,56,52,56,4,0
452,469,17,18,0.7222222222,0.8333333333,1,17.5,0.7816901408,0.8098591549,0.5555555556,0.7183098592,17,18,17,18,1,0,0,0,2,1,1,119,142,119,142,23,0
64,78,12,15,0.2,0.3333333333,3,13.5,0.4324324324,0.6486486486,0.2,0.4594594595,12,15,12,15,3,0,0,0,2,1,1,65,74,65,74,9,0
476,497,22,22,1,1,0,22,1,1,1,1,22,22,22,22,0,0,0,0,2,1,1,154,154,154,154,0,0
886,969,27,84,0.021978022,0.1208791209,57,55.5,0.1796116505,0.265776699,0.021978022,0.1347087379,31,91,31,91,60,0,0,0,2,1,1,279,824,279,824,545,0
252,267,16,18,0.2222222222,0.3333333333,2,17,0.3214285714,0.5285714286,0.2777777778,0.3571428571,18,16,16,18,2,0,0,0,2,1,1,140,99,99,140,41,0
83,92,10,10,0.4,0.6,0,10,0.5813953488,0.6511627907,0.6,0.6279069767,10,10,10,10,0,0,0,0,2,1,1,40,43,40,43,3,0
456,479,24,24,1,1,0,24,1,1,1,1,24,24,24,24,0,0,0,0,2,1,1,168,168,168,168,0,0
85,104,20,20,0.9,1,0,20,0.9756097561,1,1,1,20,20,20,20,0,2,2,4,2,1,1,82,82,82,82,0,1
6,45,40,40,1,1,0,40,1,1,1,1,39,39,39,39,0,2,2,4,2,1,1,364,364,364,364,0,0
546,568,18,23,0.68,0.72,5,20.5,0.7165775401,0.7326203209,0.32,0.5989304813,20,25,20,25,5,0,0,0,2,1,1,137,187,137,187,50,1
79,93,14,15,0.8666666667,0.8666666667,1,14.5,0.9407407407,0.9407407407,0.8666666667,0.9407407407,14,15,14,15,1,0,0,0,2,1,1,127,135,127,135,8,1
298,309,12,13,0.7142857143,0.7857142857,1,12.5,0.8837209302,0.9534883721,0.5,0.8139534884,14,13,13,14,1,0,0,0,2,1,1,86,85,85,86,1,1
1140,1153,12,14,0.5714285714,0.7857142857,2,13,0.8017241379,0.8620689655,0.7142857143,0.8275862069,12,14,12,14,2,0,0,0,2,1,1,101,116,101,116,15,1
316,325,10,10,1,1,0,10,1,1,1,1,10,10,10,10,0,0,0,0,2,1,1,44,44,44,44,0,1
1143,1168,24,26,0.8461538462,0.8846153846,2,25,0.9069767442,0.9244186047,0.0384615385,0.8023255814,24,26,24,26,2,0,0,0,2,1,1,161,172,161,172,11,1
397,415,19,19,0.9473684211,0.9473684211,0,19,0.9534883721,0.9534883721,0.9473684211,0.9534883721,19,19,19,19,0,4,4,8,2,1,1,123,129,123,129,6,1
522,540,19,19,1,1,0,19,1,1,1,1,20,20,20,20,0,0,0,0,2,1,1,235,235,235,235,0,1
1532,1546,15,17,0.6470588235,0.8235294118,2,16,0.838028169,0.9084507042,0.5882352941,0.8591549296,17,15,15,17,2,0,0,0,2,1,1,142,129,129,142,13,1
59,61,3,3,0.3333333333,0.6666666667,0,3,0.8571428571,0.9285714286,0.6666666667,0.9285714286,3,3,3,3,0,0,0,0,2,1,1,52,56,52,56,4,1
30,44,15,15,1,1,0,15,1,1,1,1,15,15,15,15,0,0,0,0,2,1,1,72,72,72,72,0,1
119,128,10,10,0.3,0.7,0,10,0.5064935065,0.6883116883,0.4,0.5194805195,10,10,10,10,0,0,0,0,2,1,1,77,61,61,77,16,0
7,7,1,1,0,0,0,1,0.1010716025,0.2004383829,0,0.2004383829,1,1,1,1,0,0,0,0,0,0,0,824,4106,824,4106,3282,0
265,282,18,18,0,0.9444444444,0,18,0.8055555556,0.9722222222,0.9444444444,0.95,18,18,18,18,0,0,0,0,2,1,1,180,180,180,180,0,1
27,158,132,132,1,1,0,132,1,1,1,1,122,122,122,122,0,0,0,0,0,0,0,1084,1084,1084,1084,0,1
63,76,14,20,0.1538461538,0.2307692308,6,17,0.2873563218,0.5057471264,0.1538461538,0.4022988506,11,13,11,13,2,0,2,2,4,2,2,74,87,74,87,13,0
142,195,39,54,0.6481481481,0.7222222222,15,46.5,0.7774566474,0.7976878613,0.6481481481,0.7774566474,39,54,39,54,15,0,0,0,2,1,1,276,346,276,346,70,1
48,55,7,8,0.375,0.75,1,7.5,0.7058823529,0.8823529412,0.5,0.8235294118,7,8,7,8,1,0,0,0,2,1,1,34,34,34,34,0,0
548,570,23,23,0.88,1,0,23,0.9786096257,1,1,1,25,25,25,25,0,0,0,0,2,1,1,187,187,187,187,0,1
1295,1330,36,36,1,1,0,36,1,1,1,1,38,38,38,38,0,0,0,0,2,1,1,289,289,289,289,0,1
9,24,16,16,1,1,0,16,1,1,1,1,16,16,16,16,0,0,0,0,2,1,1,128,128,128,128,0,1
366,396,31,31,1,1,0,31,1,1,1,1,31,31,31,31,0,0,0,0,2,1,1,217,217,217,217,0,1
629,646,18,18,1,1,0,18,1,1,1,1,20,20,20,20,0,0,0,0,2,1,1,137,137,137,137,0,1
687,703,17,17,1,1,0,17,1,1,1,1,17,17,17,17,0,0,0,0,2,1,1,84,84,84,84,0,1
376,386,10,11,0.1818181818,0.1818181818,1,10.5,0.421875,0.625,0.1818181818,0.5,10,11,10,11,1,0,0,0,2,1,1,64,64,64,64,0,0
22,29,7,8,0,0.125,1,7.5,0.3378378378,0.5540540541,0.125,0.4054054054,7,8,7,8,1,0,1,1,2,1,1,74,55,55,74,19,0
517,532,16,16,1,1,0,16,1,1,1,1,17,17,17,17,0,0,0,0,2,1,1,147,147,147,147,0,1
368,397,30,32,0.9375,0.9375,2,31,0.959798995,0.959798995,0.34375,0.7135678392,32,30,30,32,2,0,0,0,2,1,1,398,382,382,398,16,1
120,147,28,28,1,1,0,28,1,1,1,1,28,28,28,28,0,0,0,0,2,1,1,142,142,142,142,0,1
960,971,12,14,0.5714285714,0.7857142857,2,13,0.8017241379,0.8620689655,0.7142857143,0.8275862069,14,12,12,14,2,0,0,0,2,1,1,116,101,101,116,15,1
255,273,18,19,0.3157894737,0.7368421053,1,18.5,0.7672413793,0.8793103448,0.2105263158,0.6637931034,18,19,18,19,1,0,0,0,2,1,1,111,116,111,116,5,1
615,641,27,30,0.3666666667,0.8666666667,3,28.5,0.6956521739,0.7584541063,0.2333333333,0.6111111111,30,27,27,30,3,0,0,0,2,1,1,414,314,314,414,100,1
242,294,53,70,0.5238095238,0.9523809524,17,61.5,0.848,0.92,0.9523809524,0.92,21,21,21,21,0,1,1,2,3,2,1,250,231,231,250,19,0
76,87,12,12,1,1,0,12,1,1,1,1,12,12,12,12,0,1,1,2,2,1,1,112,112,112,112,0,0
443,485,43,43,1,1,0,43,1,1,1,1,46,46,46,46,0,0,0,0,2,1,1,314,314,314,314,0,1
538,557,20,20,0.9047619048,0.9047619048,0,20,0.9495798319,0.9495798319,0.2857142857,0.6974789916,21,21,21,21,0,0,0,0,2,1,1,114,119,114,119,5,1
306,337,32,32,1,1,0,32,1,1,1,1,32,32,32,32,0,0,0,0,2,1,1,224,224,224,224,0,1
346,377,32,32,1,1,0,32,1,1,1,1,32,32,32,32,0,0,0,0,2,1,1,398,398,398,398,0,1
1259,1269,11,11,0.9090909091,1,0,11,0.9841269841,1,1,1,11,11,11,11,0,1,1,2,2,1,1,63,63,63,63,0,1
1062,1078,17,18,0.3333333333,0.9444444444,1,17.5,0.8540540541,0.9621621622,0.7222222222,0.9297297297,18,17,17,18,1,0,0,0,2,1,1,185,178,178,185,7,1
1532,1546,14,15,0.5333333333,0.9333333333,1,14.5,0.8682170543,0.9302325581,0.3333333333,0.7984496124,14,15,14,15,1,0,0,0,2,1,1,120,129,120,129,9,1
1,63,63,63,1,1,0,63,1,1,1,1,57,57,57,57,0,0,0,0,0,0,0,545,545,545,545,0,1
24,30,7,7,0.875,1,0,7,0.9841269841,1,1,1,8,8,8,8,0,0,0,0,2,1,1,63,63,63,63,0,1
38,42,5,17,0,0,12,11,0.2716049383,0.5432098765,0,0.3580246914,11,5,5,11,6,1,0,1,3,2,1,81,63,63,81,18,0
10,10,1,1,1,1,0,1,1,1,1,1,1,1,1,1,0,0,0,0,0,0,0,2099,2099,2099,2099,0,0
112,131,20,26,0.6538461538,0.6923076923,6,23,0.7876106195,0.8008849558,0.4230769231,0.685840708,26,20,20,26,6,0,0,0,2,1,1,226,184,184,226,42,1
366,398,33,33,1,1,0,33,1,1,1,1,33,33,33,33,0,1,1,2,2,1,1,205,205,205,205,0,1
588,598,11,11,0.7692307692,0.9230769231,0,11,0.9494949495,0.9898989899,0.9230769231,0.9898989899,13,13,13,13,0,0,0,0,2,1,1,99,99,99,99,0,0
70,94,25,25,0.75,1,0,25,0.9710743802,1,1,1,28,28,28,28,0,1,1,2,2,1,1,242,242,242,242,0,0
356,372,17,17,1,1,0,17,1,1,1,1,17,17,17,17,0,0,0,0,2,1,1,119,119,119,119,0,1
56,66,11,13,0.2857142857,0.2857142857,2,12,0.44,0.62,0.2142857143,0.45,14,12,12,14,2,0,0,0,2,1,1,99,100,99,100,1,0
406,441,36,36,1,1,0,36,1,1,1,1,38,38,38,38,0,0,0,0,2,1,1,349,349,349,349,0,1
449,465,17,17,0.7058823529,0.7647058824,0,17,0.7692307692,0.8269230769,0.2352941176,0.6057692308,17,17,17,17,0,0,0,0,2,1,1,104,88,88,104,16,1
135,146,12,12,0.9166666667,1,0,12,0.9913793103,1,1,1,12,12,12,12,0,0,0,0,2,1,1,116,116,116,116,0,1
524,546,23,23,1,1,0,23,1,1,1,1,25,25,25,25,0,0,0,0,2,1,1,187,187,187,187,0,1
232,250,19,19,0.7894736842,1,0,19,0.9743589744,1,1,1,19,19,19,19,0,1,1,2,4,2,2,156,156,156,156,0,1
355,365,11,11,0.5384615385,0.5384615385,0,11,0.7684210526,0.8105263158,0.3846153846,0.6315789474,13,13,13,13,0,0,0,0,2,1,1,95,91,91,95,4,1
149,157,9,9,1,1,0,9,1,1,1,1,11,11,11,11,0,0,0,0,2,1,1,105,105,105,105,0,1
48,62,15,15,1,1,0,15,1,1,1,1,16,16,16,16,0,0,0,0,2,1,1,119,119,119,119,0,1
135,306,172,172,1,1,0,172,1,1,1,1,167,167,167,167,0,1,1,2,4,2,2,1270,1270,1270,1270,0,1
73,82,10,10,1,1,0,10,1,1,1,1,10,10,10,10,0,0,0,0,2,1,1,62,62,62,62,0,1
345,361,17,17,1,1,0,17,1,1,1,1,17,17,17,17,0,0,0,0,2,1,1,119,119,119,119,0,0
660,676,17,17,0.8235294118,0.8823529412,0,17,0.9029126214,0.9417475728,0.7058823529,0.8834951456,17,17,17,17,0,0,0,0,2,1,1,100,103,100,103,3,0
75,102,28,28,0.8387096774,1,0,28,0.9805447471,1,1,1,31,31,31,31,0,1,1,2,2,1,1,257,257,257,257,0,1
43,67,25,25,0,0,0,25,0.375,0.625,0,0.4711538462,13,13,13,13,0,0,0,0,0,0,0,78,104,78,104,26,0
1397,1405,9,9,1,1,0,9,1,1,1,1,9,9,9,9,0,0,0,0,2,1,1,98,98,98,98,0,1
848,857,10,10,0.3,0.4,0,10,0.4655172414,0.6379310345,0.3,0.4827586207,10,10,10,10,0,0,0,0,2,1,1,58,46,46,58,12,0
36,51,16,22,0.5,0.6818181818,6,19,0.614379085,0.6862745098,0.2272727273,0.4901960784,22,16,16,22,6,0,0,0,2,1,1,153,106,106,153,47,0
219,228,10,10,0.8333333333,0.9166666667,0,10,0.9759036145,0.9879518072,0.9166666667,0.9879518072,12,12,12,12,0,0,0,0,2,1,1,83,82,82,83,1,1
25,43,19,19,0.8666666667,0.8666666667,0,19,0.8571428571,0.8681318681,0.2666666667,0.5989010989,15,15,15,15,0,2,2,4,2,1,1,182,158,158,182,24,1
146,156,11,11,0.2727272727,0.5454545455,0,11,0.5555555556,0.7777777778,0.2727272727,0.5714285714,11,11,11,11,0,0,0,0,2,1,1,60,63,60,63,3,0
770,775,6,6,1,1,0,6,1,1,1,1,6,6,6,6,0,1,1,2,2,1,1,76,76,76,76,0,1
106,122,17,17,0.6315789474,1,0,17,0.9540229885,1,1,1,19,19,19,19,0,1,1,2,2,1,1,174,174,174,174,0,1
285,306,22,24,0.5,0.8333333333,2,23,0.7518796992,0.9022556391,0.375,0.7067669173,24,22,22,24,2,0,0,0,2,1,1,133,128,128,133,5,1
598,601,4,4,1,1,0,4,1,1,1,1,6,6,6,6,0,2,2,4,2,1,1,69,69,69,69,0,1
439,456,17,18,0.3333333333,0.9444444444,1,17.5,0.8603351955,0.9608938547,0.7222222222,0.9273743017,17,18,17,18,1,0,0,0,2,1,1,172,179,172,179,7,1
318,330,11,13,0.2857142857,0.2857142857,2,12,0.4042553191,0.5212765957,0.2857142857,0.3829787234,13,14,13,14,1,0,0,0,2,1,1,75,94,75,94,19,0
73,88,14,16,0.6875,0.75,2,15,0.7363636364,0.8181818182,0.5625,0.7454545455,14,16,14,16,2,0,0,0,2,1,1,91,110,91,110,19,0
717,723,5,7,0,0,2,6,0.32,0.52,0,0.3733333333,5,7,5,7,2,1,0,1,2,1,1,75,58,58,75,17,0
629,646,18,23,0.68,0.72,5,20.5,0.7165775401,0.7326203209,0.32,0.5989304813,25,20,20,25,5,0,0,0,2,1,1,187,137,137,187,50,1
543,565,23,23,0.9565217391,0.9565217391,0,23,0.9904761905,0.9904761905,0.9565217391,0.9904761905,23,23,23,23,0,0,0,0,2,1,1,208,210,208,210,2,1
14,76,63,63,1,1,0,63,1,1,1,1,63,63,63,63,0,0,0,0,2,1,1,729,729,729,729,0,1
330,353,24,24,1,1,0,24,1,1,1,1,24,24,24,24,0,0,0,0,2,1,1,168,168,168,168,0,1
553,576,24,24,1,1,0,24,1,1,1,1,24,24,24,24,0,0,0,0,2,1,1,168,168,168,168,0,0
90,95,6,6,0.8571428571,1,0,6,0.9830508475,1,1,1,7,7,7,7,0,1,1,2,2,1,1,59,59,59,59,0,1
10,37,1,28,0.0434782609,0.0434782609,27,14.5,0.9374720858,0.9374720858,0.0434782609,0.9374720858,1,23,1,23,22,0,0,0,1,0,1,2099,2239,2099,2239,140,0
10,47,1,38,0.0384615385,0.0384615385,37,19.5,0.9333036905,0.9333036905,0.0384615385,0.9333036905,1,26,1,26,25,0,1,1,0,0,0,2099,2249,2099,2249,150,0
102,118,17,17,0.5263157895,0.8947368421,0,17,0.8516483516,0.9120879121,0.4736842105,0.7142857143,19,19,19,19,0,1,1,2,2,1,1,166,182,166,182,16,1
38,51,14,14,1,1,0,14,1,1,1,1,15,15,15,15,0,0,0,0,2,1,1,158,158,158,158,0,1
546,568,23,23,1,1,0,23,1,1,1,1,25,25,25,25,0,0,0,0,2,1,1,187,187,187,187,0,1
69,86,17,18,0.6111111111,0.6666666667,1,17.5,0.7076923077,0.8230769231,0.2777777778,0.6076923077,17,18,17,18,1,0,0,0,2,1,1,129,130,129,130,1,0
925,937,12,13,0.5384615385,0.8461538462,1,12.5,0.8925619835,0.9421487603,0.3076923077,0.7768595041,12,13,12,13,1,0,0,0,2,1,1,115,121,115,121,6,1
880,1204,325,337,0.9957081545,0.9957081545,12,331,0.996011396,0.9965811966,0.9957081545,0.9965811966,233,233,233,233,0,1,1,2,4,2,2,1755,1752,1752,1755,3,1
629,646,18,18,1,1,0,18,1,1,1,1,20,20,20,20,0,0,0,0,2,1,1,137,137,137,137,0,1
522,544,23,23,0.88,1,0,23,0.9786096257,1,1,1,25,25,25,25,0,0,0,0,2,1,1,187,187,187,187,0,1
85,110,26,26,0.9615384615,0.9615384615,0,26,0.9565217391,0.9673913043,0.4615384615,0.6956521739,26,26,26,26,0,3,3,6,2,1,1,184,178,178,184,6,1
426,438,13,13,1,1,0,13,1,1,1,1,13,13,13,13,0,0,0,0,2,1,1,94,94,94,94,0,1
255,265,10,11,0.2727272727,0.2727272727,1,10.5,0.4126984127,0.6031746032,0.2727272727,0.4920634921,10,11,10,11,1,0,0,0,2,1,1,61,63,61,63,2,1
171,181,11,11,0,1,0,11,0.8571428571,1,1,1,11,11,11,11,0,0,0,0,2,1,1,77,77,77,77,0,0
648,665,18,18,1,1,0,18,1,1,1,1,20,20,20,20,0,0,0,0,2,1,1,137,137,137,137,0,1
526,536,11,11,0.9090909091,1,0,11,0.9914529915,1,1,1,11,11,11,11,0,1,1,2,4,2,2,117,117,117,117,0,1
69,81,13,13,0.6428571429,0.7142857143,0,13,0.7888888889,0.8555555556,0.3571428571,0.6777777778,14,14,14,14,0,0,0,0,2,1,1,90,86,86,90,4,1
667,685,18,19,0.8571428571,0.9047619048,1,18.5,0.8724832215,0.8926174497,0.7142857143,0.8187919463,20,21,20,21,1,0,0,0,2,1,1,137,149,137,149,12,1
168,196,29,29,1,1,0,29,1,1,1,1,29,29,29,29,0,1,1,2,2,1,1,213,213,213,213,0,1
11,20,10,10,1,1,0,10,1,1,1,1,12,12,12,12,0,0,0,0,2,1,1,121,121,121,121,0,1
208,220,9,13,0.2307692308,0.5384615385,4,11,0.6610169492,0.7627118644,0.5384615385,0.7627118644,9,13,9,13,4,1,0,1,2,1,1,45,59,45,59,14,1
93,103,5,11,0.1,0.1,6,8,0.25,0.4583333333,0.1,0.3333333333,6,10,6,10,4,0,1,1,3,1,2,55,72,55,72,17,0
136,148,13,13,0.6428571429,0.7142857143,0,13,0.875,0.8984375,0.2857142857,0.7265625,14,14,14,14,0,0,0,0,2,1,1,123,128,123,128,5,1
569,583,15,15,1,1,0,15,1,1,1,1,15,15,15,15,0,0,0,0,2,1,1,168,168,168,168,0,1
642,654,13,13,0.1538461538,0.1538461538,0,13,0.3411764706,0.5529411765,0.1538461538,0.4470588235,13,13,13,13,0,0,0,0,2,1,1,85,81,81,85,4,0
86,95,9,10,0.5,0.9,1,9.5,0.796875,0.859375,0.5,0.8125,9,10,9,10,1,1,1,2,2,1,1,55,64,55,64,9,1
10,10,1,1,1,1,0,1,1,1,1,1,1,1,1,1,0,0,0,0,0,0,0,2099,2099,2099,2099,0,0
699,708,10,15,0.0666666667,0.3333333333,5,12.5,0.296,0.448,0.0666666667,0.336,15,10,10,15,5,0,0,0,2,1,1,125,66,66,125,59,0
1164,1192,29,29,0,0,0,29,0.3636363636,0.6363636364,0,0.5799373041,29,29,29,29,0,0,0,0,1,0,1,319,203,203,319,116,0
415,423,9,9,1,1,0,9,1,1,1,1,10,10,10,10,0,3,3,6,2,1,1,136,136,136,136,0,1
264,274,11,14,0.4285714286,0.7857142857,3,12.5,0.6896551724,0.724137931,0.5,0.7103448276,14,11,11,14,3,0,0,0,2,1,1,145,105,105,145,40,1
124,129,6,6,0.7142857143,0.8571428571,0,6,0.8405797101,0.884057971,0.2857142857,0.6231884058,7,7,7,7,0,1,1,2,2,1,1,61,69,61,69,8,1
209,228,20,20,0.9523809524,0.9523809524,0,20,0.9855072464,0.9855072464,0.4285714286,0.7898550725,21,21,21,21,0,2,2,4,2,1,1,138,137,137,138,1,1
132,141,10,10,0.5,0.6,0,10,0.6222222222,0.7111111111,0.6,0.6666666667,10,10,10,10,0,0,0,0,3,2,1,38,45,38,45,7,0
714,723,10,10,0.5833333333,0.8333333333,0,10,0.8023255814,0.9069767442,0.3333333333,0.6860465116,12,12,12,12,0,0,0,0,2,1,1,86,86,86,86,0,1
383,413,31,31,0,0,0,31,0.1904761905,0.2857142857,0,0.2380952381,31,31,31,31,0,0,0,0,2,1,1,651,217,217,651,434,0
1066,1077,12,12,0.9230769231,0.9230769231,0,12,0.9833333333,0.9916666667,0.8461538462,0.975,13,13,13,13,0,0,0,0,2,1,1,120,120,120,120,0,1
234,245,12,12,0.5833333333,0.9166666667,0,12,0.8559322034,0.9406779661,0.3333333333,0.7542372881,12,12,12,12,0,0,0,0,2,1,1,114,118,114,118,4,0
669,687,18,19,0.8571428571,0.9047619048,1,18.5,0.8724832215,0.8926174497,0.7142857143,0.8187919463,20,21,20,21,1,0,0,0,2,1,1,137,149,137,149,12,1
100,106,7,7,0.7142857143,0.8571428571,0,7,0.84375,0.90625,0.4285714286,0.71875,7,7,7,7,0,0,0,0,2,1,1,29,32,29,32,3,0
413,448,36,36,1,1,0,36,1,1,1,1,38,38,38,38,0,0,0,0,2,1,1,349,349,349,349,0,1
1010,1026,16,17,0.3529411765,0.9411764706,1,16.5,0.8370786517,0.9606741573,0.7058823529,0.9269662921,16,17,16,17,1,0,0,0,2,1,1,171,178,171,178,7,1
30,120,91,91,1,1,0,91,1,1,1,1,72,72,72,72,0,1,1,2,4,2,2,593,593,593,593,0,1
303,324,22,22,0,0,0,22,0.4285714286,0.5714285714,0,0.4415584416,22,22,22,22,0,0,0,0,2,1,1,110,154,110,154,44,1
493,507,14,15,0.5333333333,0.8666666667,1,14.5,0.7666666667,0.8333333333,0.5333333333,0.725,14,15,14,15,1,0,0,0,2,1,1,101,120,101,120,19,1
152,204,53,53,1,1,0,53,1,1,1,1,50,50,50,50,0,1,1,2,2,1,1,324,324,324,324,0,1
47,49,3,3,0,0.6666666667,0,3,0.8076923077,0.9230769231,0.6666666667,0.9038461538,3,3,3,3,0,0,0,0,2,1,1,48,52,48,52,4,0
196,215,20,20,1,1,0,20,1,1,1,1,20,20,20,20,0,4,4,8,2,1,1,184,184,184,184,0,1
56,63,8,8,0.5,0.75,0,8,0.9154929577,0.9436619718,0.75,0.9436619718,8,8,8,8,0,0,0,0,2,1,1,71,67,67,71,4,1
72,95,12,24,0.125,0.2083333333,12,18,0.3741007194,0.5251798561,0.125,0.3956834532,12,24,12,24,12,0,0,0,2,1,1,90,139,90,139,49,0
518,524,7,7,0.5714285714,0.7142857143,0,7,0.6774193548,0.8064516129,0.4285714286,0.7096774194,7,7,7,7,0,0,0,0,2,1,1,29,31,29,31,2,0
566,571,6,6,0.6666666667,1,0,6,0.9649122807,1,1,1,6,6,6,6,0,1,1,2,2,1,1,57,57,57,57,0,1
200,362,151,163,1,1,12,157,1,1,1,1,61,61,61,61,0,1,1,2,4,2,2,603,603,603,603,0,1
1007,1023,17,18,0.7777777778,0.9444444444,1,17.5,0.8992248062,0.9224806202,0.3333333333,0.7209302326,18,17,17,18,1,0,0,0,2,1,1,129,119,119,129,10,1
105,121,17,33,0,0,16,25,0.0053475936,0.2727272727,0,0.1764705882,17,17,17,17,0,0,0,0,1,0,1,68,187,68,187,119,0
452,478,27,27,1,1,0,27,1,1,1,1,27,27,27,27,0,0,0,0,2,1,1,464,464,464,464,0,1
153,184,32,37,0.3913043478,0.8260869565,5,34.5,0.8340807175,0.9596412556,0.8260869565,0.9461883408,23,21,21,23,2,1,1,2,4,2,2,223,218,218,223,5,0
25,38,10,14,0.3333333333,0.6666666667,4,12,0.896,0.968,0.6666666667,0.968,12,15,12,15,3,0,0,0,2,1,1,121,125,121,125,4,1
55,65,11,12,0.25,0.3333333333,1,11.5,0.3305084746,0.5338983051,0.25,0.3898305085,12,11,11,12,1,0,0,0,2,1,1,83,118,83,118,35,0
18,274,257,257,1,1,0,257,1,1,1,1,225,225,225,225,0,0,0,0,0,0,0,1865,1865,1865,1865,0,1
1,204,204,204,1,1,0,204,1,1,1,1,185,185,185,185,0,0,0,0,0,0,0,1550,1550,1550,1550,0,1
507,517,11,11,1,1,0,11,1,1,1,1,13,13,13,13,0,0,0,0,2,1,1,99,99,99,99,0,1
667,685,18,19,0.8571428571,0.9047619048,1,18.5,0.8724832215,0.8926174497,0.7142857143,0.8187919463,20,21,20,21,1,0,0,0,2,1,1,137,149,137,149,12,1
121,130,10,10,0.3,0.7,0,10,0.5108695652,0.6413043478,0.2,0.4673913043,10,10,10,10,0,0,0,0,2,1,1,68,92,68,92,24,0
256,266,11,11,0.8333333333,0.8333333333,0,11,0.9411764706,0.9411764706,0.8333333333,0.9411764706,12,12,12,12,0,0,0,0,2,1,1,65,68,65,68,3,1
277,288,11,12,0.5833333333,0.9166666667,1,11.5,0.9017857143,0.9375,0.3333333333,0.7767857143,11,12,11,12,1,0,0,0,2,1,1,105,112,105,112,7,1
97,103,7,7,0.625,1,0,7,0.9210526316,1,1,1,8,8,8,8,0,1,1,2,2,1,1,76,76,76,76,0,1
702,723,22,22,1,1,0,22,1,1,1,1,26,26,26,26,0,0,0,0,2,1,1,184,184,184,184,0,1
158,180,23,23,1,1,0,23,1,1,1,1,25,25,25,25,0,0,0,0,2,1,1,202,202,202,202,0,1
48,48,1,179,0,0,178,90,0.4349457882,0.4349457882,0,0.4349457882,170,1,1,170,169,5,0,5,1,1,0,2398,1044,1044,2398,1354,0
427,474,48,48,1,1,0,48,1,1,1,1,48,48,48,48,0,0,0,0,2,1,1,336,336,336,336,0,0
39,48,10,15,0.2,0.2,5,12.5,0.3170731707,0.5487804878,0.2,0.4512195122,15,11,11,15,4,0,0,0,2,1,1,82,76,76,82,6,0
157,187,31,39,0.358974359,0.7692307692,8,35,0.6890080429,0.764075067,0.2307692308,0.4852546917,39,31,31,39,8,0,0,0,2,1,1,373,285,285,373,88,0
36,66,31,31,1,1,0,31,1,1,1,1,28,28,28,28,0,1,1,2,4,2,2,198,198,198,198,0,0
1320,1352,33,33,1,1,0,33,1,1,1,1,34,34,34,34,0,0,0,0,2,1,1,202,202,202,202,0,1
97,117,21,21,1,1,0,21,1,1,1,1,20,20,20,20,0,0,0,0,4,2,2,134,134,134,134,0,0
396,411,16,16,1,1,0,16,1,1,1,1,16,16,16,16,0,0,0,0,2,1,1,92,92,92,92,0,1
1141,1153,12,13,0.5384615385,0.7692307692,1,12.5,0.8130841121,0.9065420561,0.7692307692,0.8785046729,12,13,12,13,1,0,0,0,2,1,1,101,107,101,107,6,0
501,505,5,5,0.4,0.8,0,5,0.7462686567,0.8059701493,0.8,0.776119403,5,5,5,5,0,0,0,0,2,1,1,67,56,56,67,11,0
710,722,13,13,1,1,0,13,1,1,1,1,19,19,19,19,0,0,0,0,2,1,1,169,169,169,169,0,1
169,177,9,9,1,1,0,9,1,1,1,1,9,9,9,9,0,2,2,4,2,1,1,73,73,73,73,0,1
261,276,16,18,0.3333333333,0.8333333333,2,17,0.748603352,0.9217877095,0.3888888889,0.7988826816,18,16,16,18,2,0,0,0,2,1,1,179,171,171,179,8,1
150,171,21,22,0.4545454545,0.7727272727,1,21.5,0.7783251232,0.8719211823,0.2272727273,0.6403940887,21,22,21,22,1,0,0,0,2,1,1,197,203,197,203,6,1
1138,1153,16,16,1,1,0,16,1,1,1,1,16,16,16,16,0,0,0,0,2,1,1,136,136,136,136,0,1
74,79,6,7,0.1428571429,0.7142857143,1,6.5,0.4897959184,0.8367346939,0.1428571429,0.6530612245,7,6,6,7,1,0,0,0,2,1,1,49,41,41,49,8,0
1,55,53,55,0.875,0.9375,2,54,0.9423076923,0.9679487179,0.25,0.6602564103,32,32,32,32,0,2,2,4,2,1,1,156,152,152,156,4,0
313,321,9,10,0.8,0.9,1,9.5,0.8787878788,0.9090909091,0.9,0.9090909091,10,9,9,10,1,0,0,0,2,1,1,33,30,30,33,3,1
211,220,10,10,0.6,1,0,10,0.9384615385,1,1,1,10,10,10,10,0,0,0,0,2,1,1,65,65,65,65,0,0
168,182,15,15,1,1,0,15,1,1,1,1,15,15,15,15,0,0,0,0,2,1,1,93,93,93,93,0,0
43,52,10,10,1,1,0,10,1,1,1,1,10,10,10,10,0,0,0,0,2,1,1,88,88,88,88,0,1
41,75,35,35,1,1,0,35,1,1,1,1,36,36,36,36,0,0,0,0,2,1,1,256,256,256,256,0,1
345,388,42,44,0.9318181818,0.9318181818,2,43,0.9929078014,0.9929078014,0.9318181818,0.9929078014,42,44,42,44,2,0,0,0,2,1,1,280,282,280,282,2,1
1279,1291,13,13,0.1666666667,0.3333333333,0,13,0.5727272727,0.6363636364,0.1666666667,0.4545454545,10,18,10,18,8,1,1,2,4,2,2,70,110,70,110,40,0
804,816,13,13,0.5384615385,0.9230769231,0,13,0.9344262295,0.9918032787,0.6923076923,0.9508196721,13,13,13,13,0,0,0,0,2,1,1,121,122,121,122,1,1
73,95,13,23,0.2173913043,0.347826087,10,18,0.3468208092,0.5144508671,0.1304347826,0.3526011561,13,23,13,23,10,0,0,0,2,1,1,107,173,107,173,66,0
57,87,31,31,1,1,0,31,1,1,1,1,31,31,31,31,0,0,0,0,2,1,1,220,220,220,220,0,1
385,388,4,4,0,0.75,0,4,0.88,0.98,0.75,0.96,4,4,4,4,0,0,0,0,2,1,1,50,50,50,50,0,1
220,312,93,93,0.9673913043,0.9891304348,0,93,0.9956663055,0.9989165764,0.9891304348,0.9989165764,92,92,92,92,0,3,3,6,2,1,1,923,923,923,923,0,1
378,381,4,4,0.5,0.75,0,4,0.8596491228,0.8771929825,0.25,0.6842105263,4,4,4,4,0,1,0,1,3,2,1,57,52,52,57,5,1
198,213,16,16,1,1,0,16,1,1,1,1,16,16,16,16,0,0,0,0,2,1,1,106,106,106,106,0,1
298,321,24,24,1,1,0,24,1,1,1,1,24,24,24,24,0,0,0,0,2,1,1,168,168,168,168,0,0
208,213,6,6,0,0,0,6,0.301369863,0.5068493151,0,0.4109589041,6,6,6,6,0,1,0,1,2,1,1,57,73,57,73,16,0
478,527,25,50,0.04,0.1,25,37.5,0.2886363636,0.4818181818,0.04,0.3022727273,25,50,25,50,25,0,0,0,2,1,1,280,440,280,440,160,0
226,239,14,14,1,1,0,14,1,1,1,1,14,14,14,14,0,0,0,0,2,1,1,167,167,167,167,0,1
460,501,30,42,1,1,12,36,1,1,1,1,29,29,29,29,0,2,2,4,4,2,2,258,258,258,258,0,1
648,665,18,23,0.68,0.72,5,20.5,0.7165775401,0.7326203209,0.32,0.5989304813,25,20,20,25,5,0,0,0,2,1,1,187,137,137,187,50,1
652,658,7,7,1,1,0,7,1,1,1,1,8,8,8,8,0,1,1,2,2,1,1,91,91,91,91,0,1
70,78,9,9,0.7,0.7,0,9,0.9402985075,0.9552238806,0.7,0.9552238806,10,10,10,10,0,0,0,0,2,1,1,67,67,67,67,0,1
193,259,18,67,0.0298507463,0.0447761194,49,42.5,0.1697674419,0.2790697674,0.0298507463,0.1837209302,18,67,18,67,49,0,0,0,2,1,1,134,430,134,430,296,0
964,981,18,18,1,1,0,18,1,1,1,1,19,19,19,19,0,0,0,0,2,1,1,173,173,173,173,0,1
245,256,12,12,1,1,0,12,1,1,1,1,12,12,12,12,0,0,0,0,2,1,1,55,55,55,55,0,1
112,128,17,17,0.7368421053,1,0,17,0.9698795181,1,1,1,19,19,19,19,0,1,1,2,2,1,1,166,166,166,166,0,1
379,417,20,39,0.075,0.175,19,29.5,0.2777777778,0.4567901235,0.075,0.3302469136,21,40,21,40,19,0,0,0,2,1,1,182,324,182,324,142,0
1187,1227,23,41,0.0731707317,0.0975609756,18,32,0.1978609626,0.3502673797,0.0731707317,0.256684492,24,41,24,41,17,0,0,0,2,1,1,193,374,193,374,181,0
602,610,9,9,0.8181818182,0.9090909091,0,9,0.9733333333,0.9866666667,0.9090909091,0.9866666667,11,11,11,11,0,0,0,0,2,1,1,75,75,75,75,0,1
114,120,7,7,0.625,0.875,0,7,0.8481012658,0.8987341772,0.25,0.6455696203,8,8,8,8,0,0,0,0,2,1,1,71,79,71,79,8,1
572,602,31,33,0.9090909091,0.9090909091,2,32,0.9917695473,0.9917695473,0.9090909091,0.9917695473,33,31,31,33,2,0,0,0,2,1,1,243,241,241,243,2,1
126,138,13,13,1,1,0,13,1,1,1,1,13,13,13,13,0,0,0,0,2,1,1,111,111,111,111,0,1
304,323,20,20,1,1,0,20,1,1,1,1,22,22,22,22,0,0,0,0,2,1,1,321,321,321,321,0,1
308,322,15,15,1,1,0,15,1,1,1,1,15,15,15,15,0,0,0,0,2,1,1,162,162,162,162,0,1
88,101,14,14,0.8125,1,0,14,0.9781021898,1,1,1,16,16,16,16,0,1,1,2,2,1,1,137,137,137,137,0,0
276,285,10,10,1,1,0,10,1,1,1,1,10,10,10,10,0,0,0,0,2,1,1,45,45,45,45,0,1
332,345,14,15,0.3333333333,0.6666666667,1,14.5,0.5487804878,0.7682926829,0.4666666667,0.6219512195,15,14,14,15,1,0,0,0,2,1,1,82,80,80,82,2,0
133,139,7,7,0.4285714286,0.7142857143,0,7,0.5806451613,0.7741935484,0.7142857143,0.7741935484,7,7,7,7,0,0,0,0,2,1,1,27,31,27,31,4,0
134,228,93,95,0.6578947368,0.9736842105,2,94,0.9210526316,0.9851258581,0.4298245614,0.8421052632,112,114,112,114,2,0,0,0,2,1,1,874,871,871,874,3,1
46,66,21,21,1,1,0,21,1,1,1,1,19,19,19,19,0,1,1,2,4,2,2,169,169,169,169,0,1
546,568,23,23,1,1,0,23,1,1,1,1,25,25,25,25,0,0,0,0,2,1,1,187,187,187,187,0,1
793,802,10,10,0.9,1,0,10,0.9910714286,1,1,1,10,10,10,10,0,1,1,2,2,1,1,112,112,112,112,0,1
439,459,20,21,0.1818181818,0.2272727273,1,20.5,0.2588832487,0.421319797,0.1818181818,0.2944162437,20,22,20,22,2,0,0,0,2,1,1,107,197,107,197,90,0
495,503,9,9,0.6363636364,0.7272727273,0,9,0.6666666667,0.7466666667,0.4545454545,0.56,11,11,11,11,0,0,0,0,2,1,1,75,64,64,75,11,0
202,265,64,64,1,1,0,64,1,1,1,1,64,64,64,64,0,0,0,0,2,1,1,511,511,511,511,0,1
506,524,19,19,1,1,0,19,1,1,1,1,20,20,20,20,0,0,0,0,2,1,1,235,235,235,235,0,1
337,366,30,30,0.9333333333,0.9333333333,0,30,0.9720670391,0.9832402235,0.2333333333,0.7262569832,30,30,30,30,0,4,4,8,4,2,2,178,179,178,179,1,1
648,665,18,18,0.9,1,0,18,0.9854014599,1,1,1,20,20,20,20,0,0,0,0,2,1,1,137,137,137,137,0,1
678,685,8,8,1,1,0,8,1,1,1,1,9,9,9,9,0,1,1,2,2,1,1,52,52,52,52,0,1
485,490,6,6,0.6666666667,1,0,6,0.9649122807,1,1,1,6,6,6,6,0,1,1,2,2,1,1,57,57,57,57,0,1
30,45,10,16,0.1875,0.1875,6,13,0.2601626016,0.3821138211,0.1875,0.2926829268,11,16,11,16,5,0,0,0,2,1,1,78,123,78,123,45,0
401,430,30,30,1,1,0,30,1,1,1,1,30,30,30,30,0,0,0,0,2,1,1,210,210,210,210,0,0
479,494,16,18,0.3333333333,0.8333333333,2,17,0.748603352,0.9217877095,0.3888888889,0.7988826816,18,16,16,18,2,0,0,0,2,1,1,179,171,171,179,8,1
23,41,19,19,0.8666666667,0.8666666667,0,19,0.8571428571,0.8681318681,0.2666666667,0.5989010989,15,15,15,15,0,2,2,4,2,1,1,158,182,158,182,24,1
827,857,31,31,1,1,0,31,1,1,1,1,32,32,32,32,0,0,0,0,2,1,1,243,243,243,243,0,1
94,103,10,10,0.5,1,0,10,0.9230769231,1,1,1,10,10,10,10,0,0,0,0,2,1,1,65,65,65,65,0,1
10,10,1,612,0.0357142857,0.0357142857,611,306.5,0.9316466933,0.9316466933,0.0357142857,0.9316466933,28,1,1,28,27,1,0,1,0,0,0,2253,2099,2099,2253,154,0
160,167,1,8,0.5,0.5,7,4.5,0.502283105,0.502283105,0.5,0.502283105,1,2,1,2,1,0,0,0,0,0,0,330,657,330,657,327,0
215,226,12,15,0.8,0.8,3,13.5,0.8656716418,0.8656716418,0.7333333333,0.8507462687,15,12,12,15,3,0,0,0,2,1,1,67,58,58,67,9,1
23,64,42,42,1,1,0,42,1,1,1,1,39,39,39,39,0,0,0,0,0,0,0,397,397,397,397,0,1
522,544,23,23,0.88,1,0,23,0.9786096257,1,1,1,25,25,25,25,0,0,0,0,2,1,1,187,187,187,187,0,1
1401,1417,14,17,0.5294117647,0.7647058824,3,15.5,0.7385620915,0.7973856209,0.2941176471,0.6732026144,14,17,14,17,3,0,0,0,2,1,1,122,153,122,153,31,1
522,544,19,23,0.68,0.72,4,21,0.7326203209,0.7754010695,0.32,0.6256684492,21,25,21,25,4,0,0,0,2,1,1,149,187,149,187,38,0
10,27,1,18,0.0666666667,0.0666666667,17,9.5,0.9619615032,0.9619615032,0.0666666667,0.9619615032,1,15,1,15,14,0,0,0,0,0,0,2099,2182,2099,2182,83,0
177,206,23,30,0.2,0.2333333333,7,26.5,0.3631284916,0.5810055866,0.2,0.4078212291,23,30,23,30,7,0,0,0,2,1,1,165,179,165,179,14,0
123,130,8,8,0.75,1,0,8,0.9759036145,1,1,1,8,8,8,8,0,1,1,2,2,1,1,83,83,83,83,0,1
1,450,450,450,1,1,0,450,1,1,1,1,441,441,441,441,0,0,0,0,0,0,0,3481,3481,3481,3481,0,1
144,156,11,13,0.5384615385,0.7692307692,2,12,0.6736111111,0.7152777778,0.4615384615,0.6597222222,11,13,11,13,2,0,0,0,2,1,1,103,144,103,144,41,0
369,396,28,28,0.9655172414,0.9655172414,0,28,0.964028777,0.964028777,0.9655172414,0.964028777,29,29,29,29,0,1,1,2,2,1,1,268,278,268,278,10,1
259,306,48,48,1,1,0,48,1,1,1,1,48,48,48,48,0,0,0,0,2,1,1,309,309,309,309,0,1
281,298,18,18,0,1,0,18,0.5714285714,1,1,1,18,18,18,18,0,0,0,0,2,1,1,126,126,126,126,0,0
261,278,18,18,0.8888888889,1,0,18,0.9788732394,1,1,1,18,18,18,18,0,0,0,0,2,1,1,142,142,142,142,0,1
522,544,18,23,0.68,0.72,5,20.5,0.7165775401,0.7326203209,0.32,0.5989304813,20,25,20,25,5,0,0,0,2,1,1,137,187,137,187,50,1
474,483,10,10,1,1,0,10,1,1,1,1,11,11,11,11,0,0,0,0,2,1,1,78,78,78,78,0,1
80,104,25,25,0.75,1,0,25,0.9710743802,1,1,1,28,28,28,28,0,1,1,2,2,1,1,242,242,242,242,0,0
594,604,11,11,0.7272727273,1,0,11,0.96875,1,1,1,11,11,11,11,0,1,1,2,2,1,1,128,128,128,128,0,1
99,111,13,13,1,1,0,13,1,1,1,1,13,13,13,13,0,0,0,0,2,1,1,117,117,117,117,0,1
459,484,26,26,1,1,0,26,1,1,1,1,26,26,26,26,0,0,0,0,2,1,1,182,182,182,182,0,1
506,524,19,19,1,1,0,19,1,1,1,1,20,20,20,20,0,0,0,0,2,1,1,235,235,235,235,0,1
61,110,50,50,1,1,0,50,1,1,1,1,50,50,50,50,0,2,2,4,2,1,1,348,348,348,348,0,1
881,899,19,19,0.3333333333,1,0,19,0.9395348837,1,1,1,18,18,18,18,0,1,1,2,4,2,2,215,215,215,215,0,1
280,285,6,6,1,1,0,6,1,1,1,1,7,7,7,7,0,2,2,4,2,1,1,106,106,106,106,0,1
60,84,25,25,0.6071428571,1,0,25,0.9465020576,1,1,1,28,28,28,28,0,1,1,2,2,1,1,243,243,243,243,0,1
139,155,16,17,0.5294117647,0.5294117647,1,16.5,0.6949152542,0.7372881356,0.2941176471,0.6440677966,16,17,16,17,1,0,0,0,2,1,1,107,118,107,118,11,1
890,916,27,27,0.8888888889,0.962962963,0,27,0.945,0.965,0.8148148148,0.935,27,27,27,27,0,0,0,0,2,1,1,193,200,193,200,7,1
209,223,15,15,1,1,0,15,1,1,1,1,15,15,15,15,0,0,0,0,2,1,1,206,206,206,206,0,1
570,590,21,23,0.84,0.88,2,22,0.8395721925,0.871657754,0.68,0.807486631,25,23,23,25,2,0,0,0,2,1,1,187,166,166,187,21,1
115,120,6,6,0.8333333333,1,0,6,0.975,1,1,1,6,6,6,6,0,0,0,0,2,1,1,40,40,40,40,0,1
136,149,14,14,0.6875,0.9375,0,14,0.9562043796,0.9854014599,0.9375,0.9854014599,16,16,16,16,0,1,1,2,2,1,1,137,137,137,137,0,1
15,29,15,15,1,1,0,15,1,1,1,1,16,16,16,16,0,0,0,0,2,1,1,153,153,153,153,0,1
4,20,17,17,1,1,0,17,1,1,1,1,15,15,15,15,0,0,0,0,0,0,0,143,143,143,143,0,1
336,359,24,24,0,0,0,24,0.3636363636,0.5454545455,0,0.3674242424,24,24,24,24,0,0,0,0,2,1,1,264,168,168,264,96,0
356,364,9,19,0,0.0769230769,10,14,0.3369565217,0.5326086957,0,0.3804347826,13,9,9,13,4,0,1,1,3,2,1,92,74,74,92,18,0
705,715,7,11,0.3,0.3,4,9,0.8333333333,0.8611111111,0.3,0.8611111111,6,10,6,10,4,1,1,2,4,2,2,62,72,62,72,10,0
49,60,12,12,1,1,0,12,1,1,1,1,12,12,12,12,0,2,2,4,2,1,1,81,81,81,81,0,0
64,95,32,33,0.1212121212,0.1515151515,1,32.5,0.3565217391,0.5913043478,0.1212121212,0.3652173913,33,32,32,33,1,0,0,0,2,1,1,212,230,212,230,18,0
98,113,15,16,0.0625,0.75,1,15.5,0.2697674419,0.4465116279,0.0625,0.2744186047,15,16,15,16,1,0,0,0,2,1,1,104,215,104,215,111,0
48,719,672,672,1,1,0,672,1,1,1,1,576,576,576,576,0,0,0,0,0,0,0,4906,4906,4906,4906,0,0
296,312,17,17,1,1,0,17,1,1,1,1,17,17,17,17,0,0,0,0,2,1,1,119,119,119,119,0,0
32,48,17,21,0.5238095238,0.7619047619,4,19,0.6621621622,0.75,0.380952381,0.6554054054,21,17,17,21,4,0,0,0,2,1,1,148,115,115,148,33,0
10,35,1,26,0.0476190476,0.0476190476,25,13.5,0.943794964,0.943794964,0.0476190476,0.943794964,1,21,1,21,20,0,1,1,1,0,1,2099,2224,2099,2224,125,0
223,230,8,8,0.875,0.875,0,8,0.610619469,0.6637168142,0.125,0.4690265487,8,8,8,8,0,1,1,2,2,1,1,77,113,77,113,36,1
380,427,48,48,1,1,0,48,1,1,1,1,48,48,48,48,0,0,0,0,2,1,1,336,336,336,336,0,0
459,547,7,89,0.1206896552,0.1206896552,82,48,0.263322884,0.263322884,0.1206896552,0.263322884,7,58,7,58,51,1,0,1,3,1,2,168,638,168,638,470,0
459,472,13,14,0.7142857143,0.7857142857,1,13.5,0.8796992481,0.9172932331,0.5714285714,0.7969924812,13,14,13,14,1,0,0,0,2,1,1,133,128,128,133,5,1
824,830,7,7,0.7142857143,0.7142857143,0,7,0.8867924528,0.9245283019,0.2857142857,0.7169811321,7,7,7,7,0,0,0,0,2,1,1,53,49,49,53,4,0
549,586,38,38,1,1,0,38,1,1,1,1,38,38,38,38,0,2,2,4,2,1,1,269,269,269,269,0,1
28,45,18,18,1,1,0,18,1,1,1,1,18,18,18,18,0,0,0,0,2,1,1,128,128,128,128,0,1
459,490,32,32,1,1,0,32,1,1,1,1,32,32,32,32,0,0,0,0,2,1,1,224,224,224,224,0,0
335,349,15,15,1,1,0,15,1,1,1,1,15,15,15,15,0,0,0,0,2,1,1,117,117,117,117,0,1
113,124,12,12,1,1,0,12,1,1,1,1,12,12,12,12,0,0,0,0,2,1,1,67,67,67,67,0,1
560,571,11,12,0.5833333333,0.9166666667,1,11.5,0.8859649123,0.9210526316,0.3333333333,0.7719298246,11,12,11,12,1,0,0,0,2,1,1,105,114,105,114,9,1
1365,1374,10,12,0.5714285714,0.5714285714,2,11,0.75,0.75,0.1428571429,0.59375,14,11,11,14,3,0,0,0,2,1,1,96,73,73,96,23,1
1225,1230,6,7,0.8571428571,0.8571428571,1,6.5,0.9393939394,0.9393939394,0.2857142857,0.696969697,7,6,6,7,1,0,0,0,2,1,1,33,31,31,33,2,1
688,707,20,20,0.9523809524,0.9523809524,0,20,0.9912280702,0.9912280702,0.9523809524,0.9912280702,21,21,21,21,0,0,0,0,2,1,1,114,114,114,114,0,1
425,436,11,12,0.5833333333,0.9166666667,1,11.5,0.9017857143,0.9375,0.3333333333,0.7767857143,11,12,11,12,1,0,0,0,2,1,1,105,112,105,112,7,1
1535,1537,3,3,0.6666666667,1,0,3,0.95,1,1,1,6,6,6,6,0,0,0,0,2,1,1,40,40,40,40,0,0
1279,1312,34,37,0.6216216216,0.7567567568,3,35.5,0.7002881844,0.7550432277,0.3243243243,0.5043227666,37,34,34,37,3,0,0,0,2,1,1,347,282,282,347,65,0
642,651,10,10,0.3,0.7,0,10,0.6,0.8363636364,0.3,0.6181818182,10,10,10,10,0,0,0,0,3,2,1,54,55,54,55,1,0
142,194,53,53,1,1,0,53,1,1,1,1,50,50,50,50,0,1,1,2,2,1,1,324,324,324,324,0,0
149,178,1,30,0.1111111111,0.1111111111,29,15.5,0.2430044183,0.2430044183,0.1111111111,0.2430044183,1,9,1,9,8,0,0,0,0,0,0,330,1358,330,1358,1028,0
449,470,22,22,1,1,0,22,1,1,1,1,22,22,22,22,0,0,0,0,2,1,1,154,154,154,154,0,0
385,416,32,32,1,1,0,32,1,1,1,1,32,32,32,32,0,0,0,0,2,1,1,224,224,224,224,0,0
203,253,51,51,1,1,0,51,1,1,1,1,15,15,15,15,0,1,1,2,4,2,2,104,104,104,104,0,0
297,326,30,34,0.1764705882,0.3235294118,4,32,0.3333333333,0.4718614719,0.1764705882,0.3376623377,34,32,32,34,2,0,0,0,2,1,1,231,165,165,231,66,0
369,379,11,11,0.9166666667,0.9166666667,0,11,0.9846153846,0.9846153846,0.9166666667,0.9846153846,12,12,12,12,0,0,0,0,2,1,1,65,65,65,65,0,1
315,340,26,26,0,0,0,26,0.1904761905,0.2857142857,0,0.2380952381,26,26,26,26,0,0,0,0,2,1,1,546,182,182,546,364,0
165,176,12,13,0.5384615385,0.7692307692,1,12.5,0.7708333333,0.8472222222,0.4615384615,0.7361111111,13,12,12,13,1,0,0,0,2,1,1,144,126,126,144,18,1
9,20,12,12,1,1,0,12,1,1,1,1,14,14,14,14,0,0,0,0,2,1,1,133,133,133,133,0,1
427,457,31,31,0,0,0,31,0.4285714286,0.5714285714,0,0.4377880184,31,31,31,31,0,0,0,0,2,1,1,155,217,155,217,62,0
50,61,12,12,1,1,0,12,1,1,1,1,12,12,12,12,0,0,0,0,2,1,1,83,83,83,83,0,1
549,567,13,19,0.0588235294,0.0588235294,6,16,0.3255813953,0.6046511628,0.0588235294,0.4186046512,13,17,13,17,4,0,0,0,2,1,1,172,157,157,172,15,0
546,568,23,23,1,1,0,23,1,1,1,1,25,25,25,25,0,0,0,0,2,1,1,187,187,187,187,0,1
792,820,29,29,0.4482758621,1,0,29,0.9349112426,1,1,1,29,29,29,29,0,0,0,0,2,1,1,338,338,338,338,0,1
126,141,14,16,0.875,0.875,2,15,0.8504672897,0.8504672897,0.625,0.8130841121,14,16,14,16,2,0,0,0,2,1,1,91,107,91,107,16,1
397,428,32,32,0.9696969697,0.9696969697,0,32,0.9957983193,0.9957983193,0.9696969697,0.9957983193,33,33,33,33,0,2,2,4,2,1,1,238,238,238,238,0,1
464,494,31,31,1,1,0,31,1,1,1,1,31,31,31,31,0,0,0,0,2,1,1,217,217,217,217,0,1
533,541,9,9,1,1,0,9,1,1,1,1,10,10,10,10,0,0,0,0,2,1,1,109,109,109,109,0,1
30,36,7,7,1,1,0,7,1,1,1,1,7,7,7,7,0,0,0,0,2,1,1,41,41,41,41,0,1
200,214,15,15,1,1,0,15,1,1,1,1,15,15,15,15,0,0,0,0,2,1,1,67,67,67,67,0,1
144,157,14,14,0.7857142857,0.9285714286,0,14,0.7714285714,0.9285714286,0.9285714286,0.9142857143,14,14,14,14,0,0,0,0,2,1,1,70,68,68,70,2,1
297,306,10,10,1,1,0,10,1,1,1,1,10,10,10,10,0,0,0,0,2,1,1,77,77,77,77,0,1
459,472,14,14,1,1,0,14,1,1,1,1,14,14,14,14,0,0,0,0,2,1,1,128,128,128,128,0,1
30,65,22,36,0.1388888889,0.3055555556,14,29,0.358974359,0.5384615385,0.1388888889,0.3948717949,22,36,22,36,14,0,0,0,2,1,1,148,195,148,195,47,0
220,272,53,53,0,1,0,53,0.8181818182,1,1,1,53,53,53,53,0,0,0,0,2,1,1,583,583,583,583,0,0
250,266,5,17,0.2222222222,0.2222222222,12,11,0.3298969072,0.4639175258,0.1111111111,0.2886597938,7,9,7,9,2,0,0,0,3,1,2,97,70,70,97,27,0
178,187,10,10,0.4,0.7,0,10,0.4727272727,0.5636363636,0.5,0.4909090909,10,10,10,10,0,0,0,0,2,1,1,39,55,39,55,16,0
945,954,10,11,0.6,0.8,1,10.5,0.8163265306,0.8367346939,0.1,0.6020408163,10,9,9,10,1,1,1,2,2,1,1,98,84,84,98,14,0
768,794,21,27,0.5185185185,0.6296296296,6,24,0.6939655172,0.7586206897,0.3703703704,0.6594827586,21,27,21,27,6,0,0,0,2,1,1,194,232,194,232,38,0
1325,1364,40,40,1,1,0,40,1,1,1,1,37,37,37,37,0,0,0,0,4,2,2,256,256,256,256,0,0
1201,1214,14,14,0.7857142857,1,0,14,0.9666666667,1,1,1,14,14,14,14,0,0,0,0,2,1,1,120,120,120,120,0,0
503,532,27,30,0.2666666667,0.2666666667,3,28.5,0.3205128205,0.5213675214,0.2666666667,0.3803418803,27,30,27,30,3,0,0,0,2,1,1,164,234,164,234,70,0
310,322,13,13,0.8461538462,0.8461538462,0,13,0.9897959184,0.9897959184,0.8461538462,0.9897959184,13,13,13,13,0,0,0,0,2,1,1,196,196,196,196,0,0
47,59,13,20,0.15,0.25,7,16.5,0.3445378151,0.5294117647,0.15,0.4033613445,20,13,13,20,7,0,0,0,2,1,1,119,84,84,119,35,0
18,31,11,14,0.2857142857,0.5,3,12.5,0.7806451613,0.8387096774,0.2857142857,0.7806451613,11,14,11,14,3,0,0,0,2,1,1,145,155,145,155,10,0
159,171,12,13,0.5384615385,0.6153846154,1,12.5,0.6666666667,0.7013888889,0.4615384615,0.6458333333,12,13,12,13,1,0,0,0,2,1,1,104,144,104,144,40,0
407,436,30,30,1,1,0,30,1,1,1,1,30,30,30,30,0,0,0,0,2,1,1,210,210,210,210,0,0
329,337,9,9,0.4444444444,1,0,9,0.8305084746,1,1,1,9,9,9,9,0,1,1,2,2,1,1,59,59,59,59,0,1
748,756,9,9,0.6666666667,0.8888888889,0,9,0.9396551724,0.974137931,0,0.8965517241,9,9,9,9,0,0,0,0,2,1,1,116,115,115,116,1,1
322,360,39,39,0.9487179487,0.9487179487,0,39,0.9730639731,0.9730639731,0.8205128205,0.9562289562,39,39,39,39,0,0,0,0,2,1,1,297,296,296,297,1,1
100,104,5,5,0.6666666667,1,0,5,0.9677419355,1,1,1,6,6,6,6,0,2,2,4,2,1,1,62,62,62,62,0,1
92,103,12,15,0.2142857143,0.2142857143,3,13.5,0.3529411765,0.4852941176,0.2142857143,0.4117647059,14,12,12,14,2,0,2,2,3,2,1,68,57,57,68,11,0
10,1556,1,1547,0.0357142857,0.0357142857,1546,774,0.9316466933,0.9316466933,0.0357142857,0.9316466933,1,28,1,28,27,0,1,1,0,0,0,2099,2253,2099,2253,154,0
178,184,7,7,0.4285714286,0.7142857143,0,7,0.6,0.7333333333,0.4285714286,0.6444444444,7,7,7,7,0,0,0,0,2,1,1,45,34,34,45,11,0
10,10,1,19,0.0625,0.0625,18,10,0.9584474886,0.9584474886,0.0625,0.9584474886,16,1,1,16,15,1,0,1,1,1,0,2190,2099,2099,2190,91,0
311,338,28,28,1,1,0,28,1,1,1,1,28,28,28,28,0,1,1,2,2,1,1,192,192,192,192,0,1
574,604,31,31,1,1,0,31,1,1,1,1,31,31,31,31,0,0,0,0,2,1,1,241,241,241,241,0,1
55,69,15,15,1,1,0,15,1,1,1,1,17,17,17,17,0,0,0,0,4,2,2,104,104,104,104,0,1
762,773,12,12,0.6666666667,0.9166666667,0,12,0.8571428571,0.9553571429,0.4166666667,0.7767857143,12,12,12,12,0,0,0,0,2,1,1,112,108,108,112,4,1
284,289,6,6,0.5,0.8333333333,0,6,0.8961038961,0.9350649351,0.8333333333,0.9350649351,6,6,6,6,0,0,0,0,2,1,1,75,77,75,77,2,0
464,494,31,31,0,0,0,31,0.4285714286,0.5714285714,0,0.4377880184,31,31,31,31,0,0,0,0,2,1,1,155,217,155,217,62,0
144,160,7,17,0.125,0.125,10,12,0.338028169,0.6197183099,0.125,0.4929577465,7,8,7,8,1,1,0,1,3,1,2,57,71,57,71,14,0
62,78,17,17,0.8421052632,0.9473684211,0,17,0.9337349398,0.9518072289,0.9473684211,0.9457831325,19,19,19,19,0,1,0,1,2,1,1,166,160,160,166,6,1
141,152,12,12,0.8333333333,0.9166666667,0,12,0.9367088608,0.9746835443,0.0833333333,0.6962025316,12,12,12,12,0,0,0,0,2,1,1,77,79,77,79,2,1
77,97,17,21,0.7619047619,0.7619047619,4,19,0.7792207792,0.8051948052,0.5714285714,0.7532467532,17,21,17,21,4,0,0,0,2,1,1,125,154,125,154,29,1
20,25,6,6,0.6666666667,0.6666666667,0,6,0.8571428571,0.880952381,0.1666666667,0.7380952381,6,6,6,6,0,0,0,0,2,1,1,39,42,39,42,3,0
78,87,10,12,0.25,0.3333333333,2,11,0.3170731707,0.5731707317,0.25,0.4024390244,12,10,10,12,2,0,0,0,2,1,1,82,59,59,82,23,0
761,775,15,15,0.875,1,0,15,0.986013986,1,1,1,16,16,16,16,0,0,0,0,2,1,1,143,143,143,143,0,1
43,52,10,10,1,1,0,10,1,1,1,1,10,10,10,10,0,0,0,0,2,1,1,88,88,88,88,0,1
429,440,12,12,1,1,0,12,1,1,1,1,12,12,12,12,0,1,1,2,2,1,1,50,50,50,50,0,0
629,646,18,18,0.9,1,0,18,0.9854014599,1,1,1,20,20,20,20,0,0,0,0,2,1,1,137,137,137,137,0,1
145,178,34,34,0.7941176471,1,0,34,0.9716981132,1,1,1,34,34,34,34,0,1,1,2,2,1,1,318,318,318,318,0,1
712,722,10,11,0.5454545455,0.5454545455,1,10.5,0.7922077922,0.8181818182,0.1818181818,0.6753246753,10,11,10,11,1,0,0,0,2,1,1,77,75,75,77,2,1
573,584,9,12,0.6428571429,0.7142857143,3,10.5,0.8588235294,0.8705882353,0.5,0.6588235294,11,14,11,14,3,0,0,0,2,1,1,75,85,75,85,10,1
244,252,9,9,0.2222222222,0.8888888889,0,9,0.7945205479,0.8904109589,0.8888888889,0.8767123288,9,9,9,9,0,0,0,0,2,1,1,68,73,68,73,5,1
182,203,18,22,0.2727272727,0.6818181818,4,20,0.618556701,0.7835051546,0.3636363636,0.6391752577,18,22,18,22,4,0,0,0,2,1,1,82,97,82,97,15,1
202,233,32,32,1,1,0,32,1,1,1,1,33,33,33,33,0,0,0,0,2,1,1,235,235,235,235,0,1
600,618,10,19,0.0952380952,0.0952380952,9,14.5,0.1862068966,0.324137931,0.0952380952,0.2275862069,10,21,10,21,11,0,0,0,2,1,1,62,145,62,145,83,0
157,169,13,13,0.6666666667,0.6666666667,0,13,0.9032258065,0.9112903226,0.6666666667,0.9112903226,15,15,15,15,0,0,0,0,2,1,1,124,114,114,124,10,1
46,56,11,11,0.3636363636,0.7272727273,0,11,0.75,0.8888888889,0.5454545455,0.7638888889,11,11,11,11,0,0,0,0,2,1,1,72,67,67,72,5,1
718,737,20,20,0.9523809524,0.9523809524,0,20,0.9912280702,0.9912280702,0.9523809524,0.9912280702,21,21,21,21,0,0,0,0,2,1,1,114,114,114,114,0,1
364,376,11,13,0.3076923077,0.3076923077,2,12,0.3780487805,0.5853658537,0.3076923077,0.4756097561,11,13,11,13,2,0,0,0,2,1,1,67,82,67,82,15,0
414,433,20,20,1,1,0,20,1,1,1,1,21,21,21,21,0,0,0,0,2,1,1,189,189,189,189,0,1
164,185,22,22,1,1,0,22,1,1,1,1,24,24,24,24,0,1,1,2,2,1,1,181,181,181,181,0,1
411,419,9,9,0.5555555556,0.8888888889,0,9,0.8918918919,0.954954955,0.8888888889,0.9369369369,9,9,9,9,0,1,1,2,2,1,1,111,107,107,111,4,0
166,171,6,7,0.2857142857,0.7142857143,1,6.5,0.5357142857,0.7142857143,0.7142857143,0.7142857143,7,6,6,7,1,0,0,0,2,1,1,28,25,25,28,3,0
1239,1241,3,3,0.1666666667,0.1666666667,0,3,0.625,0.6931818182,0,0.5454545455,6,3,3,6,3,1,0,1,2,1,1,88,62,62,88,26,0
667,685,18,19,0.8571428571,0.9047619048,1,18.5,0.8724832215,0.8926174497,0.7142857143,0.8187919463,20,21,20,21,1,0,0,0,2,1,1,137,149,137,149,12,0
28,41,12,14,0.2307692308,0.3846153846,2,13,0.3466666667,0.5733333333,0.3076923077,0.44,12,13,12,13,1,2,0,2,4,2,2,75,74,74,75,1,0
143,145,3,3,0.3333333333,1,0,3,0.9655172414,1,1,1,3,3,3,3,0,0,0,0,2,1,1,58,58,58,58,0,0
1215,1225,11,11,0.6363636364,1,0,11,0.8260869565,1,1,1,11,11,11,11,0,0,0,0,2,1,1,46,46,46,46,0,1
472,493,22,22,1,1,0,22,1,1,1,1,22,22,22,22,0,0,0,0,2,1,1,154,154,154,154,0,1
334,353,19,20,0,0.05,1,19.5,0.5671641791,0.8582089552,0.05,0.8582089552,19,20,19,20,1,0,1,1,2,1,1,133,134,133,134,1,0
1420,1437,16,18,0.6111111111,0.8333333333,2,17,0.8,0.85,0.3333333333,0.74375,16,18,16,18,2,0,0,0,2,1,1,136,160,136,160,24,1
223,229,7,7,0.7142857143,0.8571428571,0,7,0.8461538462,0.9230769231,0.8571428571,0.9230769231,7,7,7,7,0,0,0,0,2,1,1,26,26,26,26,0,1
46,53,8,8,1,1,0,8,1,1,1,1,8,8,8,8,0,1,1,2,2,1,1,55,55,55,55,0,1
99,111,13,13,1,1,0,13,1,1,1,1,13,13,13,13,0,0,0,0,2,1,1,117,117,117,117,0,1
879,890,12,12,0.6923076923,1,0,12,0.8985507246,1,1,1,13,13,13,13,0,0,0,0,2,1,1,69,69,69,69,0,1
164,182,19,19,0.6842105263,0.9473684211,0,19,0.7765957447,0.9042553191,0.9473684211,0.9042553191,19,19,19,19,0,1,0,1,2,1,1,94,87,87,94,7,1
234,245,12,12,1,1,0,12,1,1,1,1,12,12,12,12,0,0,0,0,2,1,1,118,118,118,118,0,1
769,775,7,7,0.5,1,0,7,0.9512195122,1,1,1,8,8,8,8,0,2,2,4,2,1,1,82,82,82,82,0,1
546,568,23,23,0.88,1,0,23,0.9786096257,1,1,1,25,25,25,25,0,0,0,0,2,1,1,187,187,187,187,0,1
570,590,21,23,0.84,0.88,2,22,0.8395721925,0.871657754,0.68,0.807486631,25,23,23,25,2,0,0,0,2,1,1,187,166,166,187,21,1
606,613,8,8,0.125,1,0,8,0.6984126984,1,1,1,8,8,8,8,0,0,0,0,2,1,1,63,63,63,63,0,1
665,670,6,6,1,1,0,6,1,1,1,1,6,6,6,6,0,0,0,0,2,1,1,26,26,26,26,0,1
506,523,18,23,0.68,0.72,5,20.5,0.7165775401,0.7326203209,0.32,0.5989304813,25,20,20,25,5,0,0,0,2,1,1,187,137,137,187,50,1
470,865,396,398,0.9924242424,0.9924242424,2,397,0.9920969442,0.9920969442,0.9545454545,0.9857744995,264,263,263,264,1,1,0,1,4,2,2,1898,1884,1884,1898,14,1
340,349,10,10,0.8,1,0,10,0.9545454545,1,1,1,10,10,10,10,0,0,0,0,2,1,1,44,44,44,44,0,1
631,637,7,7,0.2857142857,0.8571428571,0,7,0.9150943396,0.9811320755,0.8571428571,0.9811320755,7,7,7,7,0,0,0,0,2,1,1,104,106,104,106,2,1
194,203,10,10,1,1,0,10,1,1,1,1,8,8,8,8,0,0,0,0,2,1,1,59,59,59,59,0,1
184,193,10,10,1,1,0,10,1,1,1,1,10,10,10,10,0,1,1,2,2,1,1,157,157,157,157,0,1
6,11,6,6,1,1,0,6,1,1,1,1,7,7,7,7,0,0,0,0,2,1,1,83,83,83,83,0,1
132,146,15,15,1,1,0,15,1,1,1,1,15,15,15,15,0,0,0,0,2,1,1,147,147,147,147,0,1
631,648,18,18,0.9,1,0,18,0.9854014599,1,1,1,20,20,20,20,0,0,0,0,2,1,1,137,137,137,137,0,1
82,93,12,19,0.25,0.3,7,15.5,0.3223140496,0.4628099174,0.2,0.3140495868,20,12,12,20,8,0,0,0,2,1,1,121,67,67,121,54,0
90,104,15,15,0.5294117647,0.8823529412,0,15,0.8838709677,0.935483871,0.7647058824,0.9225806452,17,17,17,17,0,0,0,0,2,1,1,147,155,147,155,8,1
546,568,23,23,1,1,0,23,1,1,1,1,25,25,25,25,0,0,0,0,2,1,1,187,187,187,187,0,1
198,210,13,13,1,1,0,13,1,1,1,1,13,13,13,13,0,0,0,0,2,1,1,60,60,60,60,0,1
440,452,13,14,0.7142857143,0.7857142857,1,13.5,0.8796992481,0.9172932331,0.5714285714,0.7969924812,14,13,13,14,1,0,0,0,2,1,1,128,133,128,133,5,1
230,245,16,17,0.6470588235,0.8235294118,1,16.5,0.8095238095,0.8571428571,0.2941176471,0.7074829932,17,16,16,17,1,0,0,0,4,2,2,147,127,127,147,20,1
200,214,15,15,1,1,0,15,1,1,1,1,15,15,15,15,0,0,0,0,2,1,1,67,67,67,67,0,1
573,587,15,15,1,1,0,15,1,1,1,1,15,15,15,15,0,0,0,0,2,1,1,147,147,147,147,0,1
533,543,11,11,0.9090909091,1,0,11,0.9914529915,1,1,1,11,11,11,11,0,1,1,2,4,2,2,117,117,117,117,0,1
200,306,107,107,1,1,0,107,1,1,1,1,104,104,104,104,0,1,1,2,4,2,2,754,754,754,754,0,0
440,452,13,13,1,1,0,13,1,1,1,1,13,13,13,13,0,0,0,0,2,1,1,133,133,133,133,0,1
522,544,21,23,0.84,0.88,2,22,0.8395721925,0.871657754,0.68,0.807486631,23,25,23,25,2,0,0,0,2,1,1,166,187,166,187,21,1
741,757,17,17,1,1,0,17,1,1,1,1,17,17,17,17,0,0,0,0,2,1,1,103,103,103,103,0,1
529,543,15,20,0.3,0.65,5,17.5,0.6153846154,0.7013574661,0.2,0.5701357466,20,15,15,20,5,0,0,0,2,1,1,221,155,155,221,66,1
27,46,20,20,1,1,0,20,1,1,1,1,20,20,20,20,0,0,0,0,2,1,1,261,261,261,261,0,1
371,386,16,18,0.3333333333,0.8888888889,2,17,0.8216216216,0.9243243243,0.6666666667,0.8918918919,18,16,16,18,2,0,0,0,2,1,1,185,171,171,185,14,1
297,306,10,10,1,1,0,10,1,1,1,1,10,10,10,10,0,0,0,0,2,1,1,77,77,77,77,0,1
27,38,11,12,0.25,0.3333333333,1,11.5,0.4533333333,0.72,0.25,0.5066666667,11,12,11,12,1,0,0,0,2,1,1,75,70,70,75,5,0
590,601,12,12,0.9166666667,1,0,12,0.9915966387,1,1,1,12,12,12,12,0,0,0,0,2,1,1,119,119,119,119,0,1
417,435,19,19,1,1,0,19,1,1,1,1,20,20,20,20,0,1,1,2,2,1,1,171,171,171,171,0,1
308,322,15,15,1,1,0,15,1,1,1,1,15,15,15,15,0,0,0,0,2,1,1,162,162,162,162,0,1
546,568,23,23,0.88,1,0,23,0.9786096257,1,1,1,25,25,25,25,0,0,0,0,2,1,1,187,187,187,187,0,1
271,287,17,17,1,1,0,17,1,1,1,1,19,19,19,19,0,0,0,0,2,1,1,179,179,179,179,0,1
641,660,20,20,0.6666666667,0.9047619048,0,20,0.8467741935,0.9112903226,0.9047619048,0.9112903226,21,21,21,21,0,0,0,0,2,1,1,114,124,114,124,10,1
321,331,11,11,0.6363636364,1,0,11,0.9619047619,1,1,1,11,11,11,11,0,0,0,0,2,1,1,105,105,105,105,0,1
522,544,23,23,1,1,0,23,1,1,1,1,25,25,25,25,0,0,0,0,2,1,1,187,187,187,187,0,1
669,687,18,19,0.8571428571,0.9047619048,1,18.5,0.8724832215,0.8926174497,0.7142857143,0.8187919463,20,21,20,21,1,0,0,0,2,1,1,137,149,137,149,12,1
65,80,15,16,0.4375,0.75,1,15.5,0.6341463415,0.8292682927,0.4375,0.6585365854,15,16,15,16,1,0,0,0,2,1,1,72,82,72,82,10,0
21,33,13,13,1,1,0,13,1,1,1,1,14,14,14,14,0,1,1,2,2,1,1,90,90,90,90,0,1
115,124,10,10,1,1,0,10,1,1,1,1,11,11,11,11,0,0,0,0,2,1,1,69,69,69,69,0,1
108,124,17,17,0.7368421053,1,0,17,0.9698795181,1,1,1,19,19,19,19,0,1,1,2,2,1,1,166,166,166,166,0,1
924,939,16,16,0.8235294118,0.8235294118,0,16,0.897810219,0.9197080292,0.2352941176,0.7226277372,17,17,17,17,0,0,0,0,2,1,1,137,126,126,137,11,1
52,90,39,39,1,1,0,39,1,1,1,1,20,20,20,20,0,1,1,2,0,0,0,185,185,185,185,0,1
135,182,48,48,1,1,0,48,1,1,1,1,48,48,48,48,0,0,0,0,2,1,1,318,318,318,318,0,1
282,297,16,16,0.375,1,0,16,0.9239766082,1,1,1,16,16,16,16,0,0,0,0,2,1,1,171,171,171,171,0,1
277,293,17,17,1,1,0,17,1,1,1,1,18,18,18,18,0,0,0,0,2,1,1,219,219,219,219,0,1
161,171,11,11,1,1,0,11,1,1,1,1,13,13,13,13,0,2,2,4,2,1,1,119,119,119,119,0,1
394,404,11,11,1,1,0,11,1,1,1,1,12,12,12,12,0,0,0,0,2,1,1,159,159,159,159,0,1
48,157,110,110,1,1,0,110,1,1,1,1,115,115,115,115,0,0,0,0,2,1,1,685,685,685,685,0,1
546,568,23,23,1,1,0,23,1,1,1,1,25,25,25,25,0,0,0,0,2,1,1,187,187,187,187,0,1
168,179,12,12,1,1,0,12,1,1,1,1,14,14,14,14,0,1,1,2,2,1,1,113,113,113,113,0,1
99,111,13,13,1,1,0,13,1,1,1,1,13,13,13,13,0,0,0,0,2,1,1,117,117,117,117,0,1
516,528,13,13,0.9285714286,0.9285714286,0,13,0.8682170543,0.8992248062,0.2857142857,0.6511627907,14,14,14,14,0,1,1,2,2,1,1,116,129,116,129,13,1
340,371,32,32,1,1,0,32,1,1,1,1,32,32,32,32,0,0,0,0,2,1,1,398,398,398,398,0,1
940,952,11,13,0.5384615385,0.8461538462,2,12,0.7933884298,0.867768595,0.3076923077,0.7107438017,11,13,11,13,2,0,0,0,2,1,1,105,121,105,121,16,1
202,265,64,64,1,1,0,64,1,1,1,1,64,64,64,64,0,0,0,0,2,1,1,511,511,511,511,0,1
293,304,12,12,1,1,0,12,1,1,1,1,14,14,14,14,0,0,0,0,2,1,1,91,91,91,91,0,1
25,66,37,42,0.6904761905,0.7619047619,5,39.5,0.8244514107,0.8463949843,0.2380952381,0.6018808777,37,42,37,42,5,0,0,0,2,1,1,284,319,284,319,35,1
416,422,7,7,1,1,0,7,1,1,1,1,7,7,7,7,0,1,1,2,2,1,1,54,54,54,54,0,1
645,670,26,26,0.8518518519,0.962962963,0,26,0.9651741294,0.9850746269,0.7407407407,0.9004975124,27,27,27,27,0,1,1,2,4,2,2,201,198,198,201,3,1
32,47,15,16,0.9375,0.9375,1,15.5,0.9230769231,0.9230769231,0.9375,0.9230769231,15,16,15,16,1,0,0,0,2,1,1,72,78,72,78,6,1
294,310,17,17,1,1,0,17,1,1,1,1,17,17,17,17,0,0,0,0,2,1,1,119,119,119,119,0,1
346,377,32,32,1,1,0,32,1,1,1,1,32,32,32,32,0,0,0,0,2,1,1,398,398,398,398,0,1
414,435,22,22,1,1,0,22,1,1,1,1,22,22,22,22,0,0,0,0,2,1,1,154,154,154,154,0,1
126,138,13,13,1,1,0,13,1,1,1,1,13,13,13,13,0,0,0,0,2,1,1,111,111,111,111,0,1
617,635,19,19,1,1,0,19,1,1,1,1,20,20,20,20,0,0,0,0,2,1,1,129,129,129,129,0,1
667,685,19,23,0.68,0.72,4,21,0.7326203209,0.7754010695,0.32,0.6256684492,25,21,21,25,4,0,0,0,2,1,1,187,149,149,187,38,1
572,582,11,11,0.8181818182,1,0,11,0.984375,1,1,1,11,11,11,11,0,1,1,2,2,1,1,128,128,128,128,0,1
572,592,21,21,1,1,0,21,1,1,1,1,23,23,23,23,0,0,0,0,2,1,1,166,166,166,166,0,1
648,665,18,19,0.8571428571,0.9047619048,1,18.5,0.8724832215,0.8926174497,0.7142857143,0.8187919463,21,20,20,21,1,0,0,0,2,1,1,149,137,137,149,12,1
160,170,11,11,1,1,0,11,1,1,1,1,11,11,11,11,0,2,2,4,2,1,1,57,57,57,57,0,1
395,405,11,14,0.4285714286,0.7857142857,3,12.5,0.6896551724,0.724137931,0.5,0.7103448276,14,11,11,14,3,0,0,0,2,1,1,145,105,105,145,40,1
126,138,13,13,1,1,0,13,1,1,1,1,13,13,13,13,0,0,0,0,2,1,1,111,111,111,111,0,1
395,405,11,12,0.8333333333,0.9166666667,1,11.5,0.8813559322,0.8898305085,0.9166666667,0.8898305085,12,11,11,12,1,0,0,0,2,1,1,118,105,105,118,13,1
39,74,35,36,0.4444444444,0.4444444444,1,35.5,0.6693333333,0.6933333333,0.2222222222,0.5546666667,35,36,35,36,1,0,0,0,2,1,1,320,375,320,375,55,1
55,69,15,15,1,1,0,15,1,1,1,1,17,17,17,17,0,0,0,0,4,2,2,104,104,104,104,0,1
590,601,12,14,0.4285714286,0.8571428571,2,13,0.768707483,0.8095238095,0.8571428571,0.8095238095,14,12,12,14,2,0,0,0,2,1,1,147,119,119,147,28,1
190,209,20,20,1,1,0,20,1,1,1,1,22,22,22,22,0,3,3,6,2,1,1,199,199,199,199,0,1
459,472,13,14,0.7142857143,0.7857142857,1,13.5,0.8796992481,0.9172932331,0.5714285714,0.7969924812,13,14,13,14,1,0,0,0,2,1,1,133,128,128,133,5,1
183,197,15,15,1,1,0,15,1,1,1,1,16,16,16,16,0,0,0,0,2,1,1,119,119,119,119,0,1
445,470,26,26,1,1,0,26,1,1,1,1,26,26,26,26,0,0,0,0,2,1,1,182,182,182,182,0,1
84,84,1,1,1,1,0,1,1,1,1,1,1,1,1,1,0,0,0,0,0,0,0,3688,3688,3688,3688,0,1
137,162,26,26,0.9230769231,1,0,26,0.9810126582,1,1,1,26,26,26,26,0,2,2,4,2,1,1,158,158,158,158,0,1
405,434,30,30,1,1,0,30,1,1,1,1,30,30,30,30,0,0,0,0,2,1,1,210,210,210,210,0,1
260,270,10,11,0.7272727273,0.8181818182,1,10.5,0.6842105263,0.7473684211,0.7272727273,0.6947368421,10,11,10,11,1,0,0,0,2,1,1,77,95,77,95,18,1
282,291,10,10,1,1,0,10,1,1,1,1,10,10,10,10,0,0,0,0,2,1,1,45,45,45,45,0,1
629,646,18,18,1,1,0,18,1,1,1,1,20,20,20,20,0,0,0,0,2,1,1,137,137,137,137,0,1
517,526,10,10,1,1,0,10,1,1,1,1,10,10,10,10,0,1,1,2,2,1,1,109,109,109,109,0,1
560,571,12,12,0.5,0.9166666667,0,12,0.8571428571,0.9579831933,0.3333333333,0.781512605,12,12,12,12,0,0,0,0,2,1,1,119,114,114,119,5,1
184,198,15,15,1,1,0,15,1,1,1,1,15,15,15,15,0,0,0,0,2,1,1,198,198,198,198,0,1
650,667,18,18,1,1,0,18,1,1,1,1,20,20,20,20,0,0,0,0,2,1,1,137,137,137,137,0,1
316,324,9,9,1,1,0,9,1,1,1,1,9,9,9,9,0,0,0,0,2,1,1,112,112,112,112,0,1
28,40,13,13,1,1,0,13,1,1,1,1,13,13,13,13,0,0,0,0,2,1,1,103,103,103,103,0,1
583,590,8,8,1,1,0,8,1,1,1,1,9,9,9,9,0,1,1,2,2,1,1,52,52,52,52,0,1
586,591,6,6,1,1,0,6,1,1,1,1,6,6,6,6,0,0,0,0,2,1,1,88,88,88,88,0,1
477,484,8,8,1,1,0,8,1,1,1,1,9,9,9,9,0,0,0,0,2,1,1,56,56,56,56,0,1
409,427,19,19,1,1,0,19,1,1,1,1,19,19,19,19,0,2,2,4,2,1,1,216,216,216,216,0,1
655,672,18,18,0.3333333333,1,0,18,0.9106145251,1,1,1,18,18,18,18,0,0,0,0,2,1,1,179,179,179,179,0,1
394,404,11,11,1,1,0,11,1,1,1,1,12,12,12,12,0,0,0,0,2,1,1,159,159,159,159,0,1
714,741,28,28,1,1,0,28,1,1,1,1,28,28,28,28,0,0,0,0,2,1,1,279,279,279,279,0,1
82,90,9,9,0.7777777778,1,0,9,0.9752066116,1,1,1,9,9,9,9,0,1,1,2,2,1,1,121,121,121,121,0,1
102,107,6,6,0.8571428571,1,0,6,0.9836065574,1,1,1,7,7,7,7,0,1,1,2,2,1,1,61,61,61,61,0,1
525,543,19,19,1,1,0,19,1,1,1,1,21,21,21,21,0,0,0,0,2,1,1,149,149,149,149,0,1
50,61,12,12,1,1,0,12,1,1,1,1,12,12,12,12,0,0,0,0,2,1,1,83,83,83,83,0,1
58,69,12,12,1,1,0,12,1,1,1,1,14,14,14,14,0,0,0,0,2,1,1,133,133,133,133,0,1
474,483,10,10,1,1,0,10,1,1,1,1,11,11,11,11,0,0,0,0,2,1,1,78,78,78,78,0,1
49,53,5,5,1,1,0,5,1,1,1,1,6,6,6,6,0,1,1,2,2,1,1,58,58,58,58,0,1
443,485,43,43,1,1,0,43,1,1,1,1,46,46,46,46,0,0,0,0,2,1,1,314,314,314,314,0,1
583,590,8,8,1,1,0,8,1,1,1,1,9,9,9,9,0,1,1,2,2,1,1,52,52,52,52,0,1
49,68,16,20,0.2,0.2,4,18,0.3442622951,0.5983606557,0.2,0.4098360656,16,20,16,20,4,0,0,0,2,1,1,122,119,119,122,3,1
667,685,18,19,0.8571428571,0.9047619048,1,18.5,0.8724832215,0.8926174497,0.7142857143,0.8187919463,20,21,20,21,1,0,0,0,2,1,1,137,149,137,149,12,1
28,97,70,70,1,1,0,70,1,1,1,1,64,64,64,64,0,1,1,2,4,2,2,584,584,584,584,0,1
531,544,14,14,0.9333333333,1,0,14,0.9880952381,1,1,1,15,15,15,15,0,3,3,6,2,1,1,84,84,84,84,0,1
204,209,6,6,0.8571428571,1,0,6,0.9830508475,1,1,1,7,7,7,7,0,1,1,2,2,1,1,59,59,59,59,0,1
124,138,15,15,1,1,0,15,1,1,1,1,15,15,15,15,0,1,1,2,2,1,1,92,92,92,92,0,1
222,228,7,7,0.7142857143,0.8571428571,0,7,0.8977272727,0.9431818182,0,0.6477272727,7,7,7,7,0,0,0,0,2,1,1,88,85,85,88,3,1
495,501,7,7,1,1,0,7,1,1,1,1,7,7,7,7,0,0,0,0,2,1,1,51,51,51,51,0,1
476,494,19,19,0.3333333333,0.9444444444,0,19,0.7621621622,0.9675675676,0.7222222222,0.9189189189,18,18,18,18,0,0,0,0,4,2,2,185,179,179,185,6,1
86,96,11,11,0.5454545455,1,0,11,0.8656716418,1,1,1,11,11,11,11,0,0,0,0,2,1,1,67,67,67,67,0,1
209,212,4,4,0.75,0.75,0,4,0.75,0.9342105263,0.75,0.8684210526,4,4,4,4,0,0,0,0,2,1,1,76,74,74,76,2,1
955,961,7,7,0.625,0.625,0,7,0.8709677419,0.8709677419,0.375,0.7580645161,8,8,8,8,0,0,0,0,2,1,1,62,54,54,62,8,1
570,590,18,21,0.7391304348,0.7826086957,3,19.5,0.7951807229,0.813253012,0.347826087,0.656626506,20,23,20,23,3,0,0,0,2,1,1,137,166,137,166,29,1
1549,1565,17,17,1,1,0,17,1,1,1,1,17,17,17,17,0,0,0,0,2,1,1,142,142,142,142,0,1
648,665,18,18,0.9,1,0,18,0.9854014599,1,1,1,20,20,20,20,0,0,0,0,2,1,1,137,137,137,137,0,1
250,269,20,20,1,1,0,20,1,1,1,1,21,21,21,21,0,0,0,0,2,1,1,209,209,209,209,0,1
112,123,12,12,1,1,0,12,1,1,1,1,13,13,13,13,0,0,0,0,2,1,1,95,95,95,95,0,1
459,472,13,14,0.7142857143,0.7857142857,1,13.5,0.8796992481,0.9172932331,0.5714285714,0.7969924812,13,14,13,14,1,0,0,0,2,1,1,133,128,128,133,5,1
247,263,17,17,1,1,0,17,1,1,1,1,19,19,19,19,0,0,0,0,2,1,1,185,185,185,185,0,1
73,85,13,13,1,1,0,13,1,1,1,1,14,14,14,14,0,0,0,0,2,1,1,160,160,160,160,0,1
73,82,10,10,1,1,0,10,1,1,1,1,10,10,10,10,0,0,0,0,2,1,1,62,62,62,62,0,1
88,104,17,17,0.7368421053,0.9473684211,0,17,0.921686747,0.9518072289,0.9473684211,0.9457831325,19,19,19,19,0,0,1,1,2,1,1,160,166,160,166,6,1
411,420,10,10,0.8,1,0,10,0.9545454545,1,1,1,10,10,10,10,0,0,0,0,2,1,1,44,44,44,44,0,1
660,667,8,8,1,1,0,8,1,1,1,1,9,9,9,9,0,1,1,2,2,1,1,52,52,52,52,0,1
711,718,8,8,1,1,0,8,1,1,1,1,7,7,7,7,0,0,0,0,4,2,2,55,55,55,55,0,1
36,41,6,6,1,1,0,6,1,1,1,1,7,7,7,7,0,0,0,0,2,1,1,62,62,62,62,0,1
199,206,8,8,1,1,0,8,1,1,1,1,8,8,8,8,0,0,0,0,2,1,1,71,71,71,71,0,1
673,686,14,14,1,1,0,14,1,1,1,1,15,15,15,15,0,0,0,0,2,1,1,86,86,86,86,0,1
84,88,5,5,0.6666666667,1,0,5,0.9677419355,1,1,1,6,6,6,6,0,2,2,4,2,1,1,62,62,62,62,0,1
1505,1510,6,6,0.8,1,0,6,0.9791666667,1,1,1,5,5,5,5,0,1,1,2,2,1,1,48,48,48,48,0,1
687,703,17,17,1,1,0,17,1,1,1,1,17,17,17,17,0,0,0,0,2,1,1,84,84,84,84,0,1
693,743,51,51,1,1,0,51,1,1,1,1,56,56,56,56,0,0,0,0,2,1,1,407,407,407,407,0,1
687,703,17,17,1,1,0,17,1,1,1,1,17,17,17,17,0,0,0,0,2,1,1,84,84,84,84,0,1
60,66,7,7,0.1428571429,0.8571428571,0,7,0.765625,0.890625,0.7142857143,0.875,7,7,7,7,0,0,1,1,2,1,1,64,58,58,64,6,1
405,410,6,6,0.6666666667,1,0,6,0.9130434783,1,1,1,6,6,6,6,0,0,0,0,2,1,1,23,23,23,23,0,1
126,133,8,8,1,1,0,8,1,1,1,1,8,8,8,8,0,0,0,0,2,1,1,71,71,71,71,0,1
174,179,6,6,0.8571428571,1,0,6,0.9830508475,1,1,1,7,7,7,7,0,1,1,2,2,1,1,59,59,59,59,0,1
147,160,14,14,0.7857142857,0.9285714286,0,14,0.7714285714,0.9285714286,0.9285714286,0.9142857143,14,14,14,14,0,0,0,0,2,1,1,68,70,68,70,2,1
99,113,15,15,0.8666666667,1,0,15,0.9829059829,1,1,1,15,15,15,15,0,0,0,0,2,1,1,117,117,117,117,0,1
234,245,12,14,0.5714285714,0.8571428571,2,13,0.8201438849,0.8489208633,0.2857142857,0.7122302158,14,12,12,14,2,0,0,0,2,1,1,139,118,118,139,21,1
825,844,20,20,0.3157894737,1,0,20,0.8385416667,1,0.9473684211,0.9947916667,19,19,19,19,0,0,0,0,4,2,2,192,192,192,192,0,1
619,627,9,9,1,1,0,9,1,1,1,1,10,10,10,10,0,0,0,0,2,1,1,78,78,78,78,0,1
449,454,6,6,0,0.5,0,6,0.87,0.95,0.3333333333,0.93,6,6,6,6,0,0,0,0,2,1,1,99,100,99,100,1,1
54,62,9,9,1,1,0,9,1,1,1,1,9,9,9,9,0,0,0,0,2,1,1,62,62,62,62,0,1
784,786,3,3,0.3333333333,0.6666666667,0,3,0.8115942029,0.8405797101,0.6666666667,0.8405797101,3,3,3,3,0,0,0,0,2,1,1,69,61,61,69,8,1
142,148,7,7,1,1,0,7,1,1,1,1,8,8,8,8,0,0,0,0,2,1,1,61,61,61,61,0,1
124,130,7,7,0.625,0.875,0,7,0.8481012658,0.8987341772,0.25,0.6455696203,8,8,8,8,0,0,0,0,2,1,1,71,79,71,79,8,1
1454,1459,6,6,0.8,1,0,6,0.9791666667,1,1,1,5,5,5,5,0,1,1,2,2,1,1,48,48,48,48,0,1
1122,1128,7,7,1,1,0,7,1,1,1,1,8,8,8,8,0,0,0,0,2,1,1,67,67,67,67,0,1
776,785,10,10,0.75,0.8333333333,0,10,0.8953488372,0.9534883721,0.3333333333,0.7325581395,12,12,12,12,0,0,0,0,2,1,1,82,86,82,86,4,1
102,107,6,6,0.5,1,0,6,0.9285714286,1,1,1,6,6,6,6,0,0,0,0,2,1,1,84,84,84,84,0,1
572,592,18,21,0.7391304348,0.7826086957,3,19.5,0.7951807229,0.813253012,0.347826087,0.656626506,20,23,20,23,3,0,0,0,2,1,1,137,166,137,166,29,1
303,311,9,9,0.8888888889,0.8888888889,0,9,0.8888888889,0.9572649573,0.8888888889,0.9487179487,9,9,9,9,0,0,0,0,2,1,1,117,117,117,117,0,1
626,651,26,26,0.8518518519,0.962962963,0,26,0.9651741294,0.9850746269,0.7407407407,0.9004975124,27,27,27,27,0,1,1,2,4,2,2,198,201,198,201,3,1
152,161,10,10,1,1,0,10,1,1,1,1,10,10,10,10,0,0,0,0,2,1,1,96,96,96,96,0,1
982,990,9,9,1,1,0,9,1,1,1,1,8,8,8,8,0,1,1,2,2,1,1,68,68,68,68,0,1
55,65,11,11,0.8181818182,1,0,11,0.9428571429,1,1,1,11,11,11,11,0,0,0,0,2,1,1,105,105,105,105,0,1
1097,1112,16,19,0.4736842105,0.8421052632,3,17.5,0.8086419753,0.8703703704,0.8421052632,0.8703703704,19,16,16,19,3,0,0,0,2,1,1,162,141,141,162,21,1
1274,1281,8,8,0.25,1,0,8,0.7755102041,1,1,1,8,8,8,8,0,0,0,0,2,1,1,49,49,49,49,0,1
12,19,8,8,0.625,0.875,0,8,0.9438202247,0.9662921348,0.25,0.8426966292,8,8,8,8,0,2,2,4,2,1,1,86,89,86,89,3,1
1532,1546,15,16,0.625,0.875,1,15.5,0.8897058824,0.9411764706,0.375,0.8235294118,16,15,15,16,1,0,0,0,2,1,1,136,129,129,136,7,1
803,816,14,14,0.6428571429,0.9285714286,0,14,0.9435483871,0.9919354839,0.7142857143,0.9516129032,14,14,14,14,0,0,0,0,2,1,1,123,124,123,124,1,1
189,200,12,12,1,1,0,12,1,1,1,1,12,12,12,12,0,1,1,2,2,1,1,136,136,136,136,0,1
1006,1019,14,15,0.5333333333,0.8666666667,1,14.5,0.8057553957,0.8633093525,0.3333333333,0.7410071942,15,14,14,15,1,0,0,0,2,1,1,139,120,120,139,19,1
739,744,6,7,0.2857142857,0.7142857143,1,6.5,0.5,0.6666666667,0.4285714286,0.6111111111,7,6,6,7,1,0,0,0,2,1,1,36,31,31,36,5,0
258,269,12,12,0.3333333333,0.4444444444,0,12,0.7,0.8333333333,0.3333333333,0.7,9,9,9,9,0,0,0,0,4,2,2,30,30,30,30,0,0
458,468,6,11,0.0909090909,0.0909090909,5,8.5,0.2833333333,0.5,0.0909090909,0.4,7,11,7,11,4,1,1,2,2,1,1,60,59,59,60,1,0
1376,1384,9,9,1,1,0,9,1,1,1,1,12,12,12,12,0,3,3,6,2,1,1,88,88,88,88,0,1
1,9,9,9,0.5,0.875,0,9,0.8225806452,0.9677419355,0.875,0.9677419355,8,8,8,8,0,0,0,0,0,0,0,60,62,60,62,2,0
293,297,5,5,0,0.1666666667,0,5,0.3780487805,0.6219512195,0,0.4634146341,6,6,6,6,0,0,1,1,2,1,1,82,61,61,82,21,0
17,45,21,29,0.0909090909,0.2727272727,8,25,0.5135135135,0.7702702703,0.2727272727,0.6486486486,8,11,8,11,3,2,1,3,1,1,0,66,74,66,74,8,0
227,237,6,11,0,0.0909090909,5,8.5,0.3209876543,0.5061728395,0,0.3703703704,7,11,7,11,4,2,3,5,3,1,2,60,81,60,81,21,0
23,28,6,7,0.1428571429,0.7142857143,1,6.5,0.48,0.82,0.1428571429,0.6,7,6,6,7,1,0,0,0,2,1,1,50,41,41,50,9,0
73,75,3,3,0,1,0,3,0.8125,1,1,1,3,3,3,3,0,0,0,0,2,1,1,48,48,48,48,0,0
142,146,5,21,0,0,16,13,0.2597402597,0.4415584416,0,0.3246753247,12,6,6,12,6,1,2,3,3,2,1,77,68,68,77,9,0
11,39,11,29,0,0.1,18,20,0.1698113208,0.2955974843,0,0.1886792453,6,20,6,20,14,1,3,4,1,0,1,47,159,47,159,112,0
1,9,8,9,0.5,0.875,1,8.5,0.8275862069,0.9310344828,0,0.5862068966,8,8,8,8,0,0,0,0,0,0,0,56,58,56,58,2,0
63,67,5,5,0,1,0,5,0.8125,1,1,1,5,5,5,5,0,0,0,0,2,1,1,80,80,80,80,0,0
98,116,13,19,0.2,0.3333333333,6,16,0.4482758621,0.724137931,0.2,0.5689655172,10,15,10,15,5,0,0,0,4,2,2,58,57,57,58,1,0
39,41,3,3,0,0.6666666667,0,3,0.75,0.9230769231,0.6666666667,0.9038461538,3,3,3,3,0,0,0,0,2,1,1,52,48,48,52,4,0
409,426,7,18,0.0714285714,0.0714285714,11,12.5,0.2567567568,0.4324324324,0.0714285714,0.3513513514,7,14,7,14,7,0,4,4,3,1,2,58,74,58,74,16,0
139,144,6,6,0.1666666667,0.8333333333,0,6,0.8412698413,0.9365079365,0.1666666667,0.746031746,6,6,6,6,0,1,1,2,2,1,1,63,63,63,63,0,1
55,55,1,1,1,1,0,1,1,1,1,1,1,1,1,1,0,0,0,0,2,1,1,1811,1811,1811,1811,0,1
314,753,440,440,0.8276836158,0.9971751412,0,440,0.9570217918,0.9993946731,0.9971751412,0.9993946731,354,354,354,354,0,1,1,2,0,0,0,3304,3302,3302,3304,2,1
682,684,3,3,0,1,0,3,0.7755102041,1,1,1,4,4,4,4,0,1,1,2,2,1,1,49,49,49,49,0,0
63,68,6,7,0.2857142857,0.7142857143,1,6.5,0.5,0.6904761905,0.7142857143,0.6428571429,7,6,6,7,1,0,0,0,2,1,1,42,36,36,42,6,0
408,416,9,9,0.4444444444,0.8888888889,0,9,0.8405797101,0.9855072464,0.8888888889,0.9565217391,9,9,9,9,0,0,0,0,2,1,1,69,69,69,69,0,0
140,144,5,5,0,0.8,0,5,0.6666666667,0.7619047619,0.8,0.7619047619,5,5,5,5,0,0,1,1,2,1,1,84,65,65,84,19,0
96,125,30,36,0.3043478261,0.7391304348,6,33,0.6504854369,0.932038835,0.347826087,0.7281553398,23,23,23,23,0,1,1,2,4,2,2,103,99,99,103,4,0
7,15,9,9,0,0.625,0,9,0.5352112676,0.7887323944,0,0.5633802817,8,8,8,8,0,0,1,1,0,0,0,66,71,66,71,5,0
209,212,4,4,0,0.75,0,4,0.6973684211,0.9342105263,0.75,0.8684210526,4,4,4,4,0,0,0,0,2,1,1,76,74,74,76,2,0
248,260,13,22,0.2727272727,0.2727272727,9,17.5,0.4727272727,0.6363636364,0.2727272727,0.4727272727,10,11,10,11,1,2,0,2,4,2,2,55,53,53,55,2,0
101,106,6,12,0.1666666667,0.8333333333,6,9,0.7857142857,0.875,0.8333333333,0.875,6,6,6,6,0,1,1,2,4,2,2,56,49,49,56,7,0
323,344,11,22,0.2,0.5,11,16.5,0.4761904762,0.7142857143,0.2,0.5396825397,9,10,9,10,1,0,0,0,4,2,2,58,63,58,63,5,0
258,279,22,24,0.2083333333,0.2916666667,2,23,0.3698630137,0.5821917808,0.2083333333,0.4178082192,24,22,22,24,2,0,0,0,2,1,1,146,133,133,146,13,0
30,122,93,93,0.9811320755,0.9811320755,0,93,0.5509950249,0.5534825871,0.9811320755,0.552238806,53,53,53,53,0,1,1,2,0,0,0,446,804,446,804,358,0
172,181,9,10,0.4,0.5,1,9.5,0.4461538462,0.6615384615,0.4,0.5384615385,10,10,10,10,0,0,0,0,2,1,1,60,65,60,65,5,0
336,343,8,8,0.5,0.75,0,8,0.7920792079,0.8811881188,0.5,0.8514851485,8,8,8,8,0,0,0,0,2,1,1,101,89,89,101,12,0
309,380,72,72,0.985915493,1,0,72,0.9985358712,1,1,1,71,71,71,71,0,1,1,2,4,2,2,683,683,683,683,0,0
289,299,9,11,0.25,0.3333333333,2,10,0.38,0.52,0.25,0.43,11,12,11,12,1,0,0,0,2,1,1,100,65,65,100,35,0
55,67,13,21,0.1428571429,0.1904761905,8,17,0.2344827586,0.3586206897,0.1428571429,0.2620689655,21,13,13,21,8,0,0,0,3,2,1,145,64,64,145,81,0
580,586,7,8,0.375,0.75,1,7.5,0.5641025641,0.7948717949,0.625,0.7692307692,8,7,7,8,1,0,0,0,3,1,2,39,35,35,39,4,0
52,106,55,55,1,1,0,55,1,1,1,1,28,28,28,28,0,1,1,2,0,0,0,241,241,241,241,0,0
648,665,18,18,1,1,0,18,1,1,1,1,20,20,20,20,0,0,0,0,2,1,1,137,137,137,137,0,1
298,301,4,6,0,0,2,5,0.3676470588,0.6323529412,0,0.4852941176,6,5,5,6,1,1,1,2,2,1,1,68,66,66,68,2,0
70,79,10,10,0.1,0.7,0,10,0.6333333333,0.9166666667,0.2,0.75,10,10,10,10,0,0,0,0,2,1,1,55,60,55,60,5,0
572,580,9,16,0.1764705882,0.2941176471,7,12.5,0.3138686131,0.4306569343,0.1176470588,0.3503649635,17,10,10,17,7,0,0,0,2,1,1,137,75,75,137,62,0
365,382,15,18,0.3333333333,0.7222222222,3,16.5,0.6162162162,0.8,0.2222222222,0.5135135135,15,18,15,18,3,0,0,0,2,1,1,154,185,154,185,31,0
676,682,7,7,0.5714285714,0.8571428571,0,7,0.6935483871,0.7903225806,0.8571428571,0.7741935484,7,7,7,7,0,1,0,1,2,1,1,53,62,53,62,9,0
125,137,13,13,0.3846153846,0.5384615385,0,13,0.5254237288,0.6779661017,0.4615384615,0.5423728814,13,13,13,13,0,0,0,0,2,1,1,59,58,58,59,1,0
266,273,8,8,0.625,0.75,0,8,0.7209302326,0.8604651163,0.5,0.6511627907,8,8,8,8,0,0,0,0,2,1,1,41,43,41,43,2,0
55,103,49,55,0.8928571429,0.8928571429,6,52,0.9253112033,0.9253112033,0.7142857143,0.9004149378,28,25,25,28,3,1,1,2,0,0,0,241,223,223,241,18,0
365,382,18,20,0.25,0.4,2,19,0.4198473282,0.5801526718,0.25,0.4809160305,20,18,18,20,2,0,0,0,2,1,1,131,97,97,131,34,0
43,54,12,12,0.25,0.25,0,12,0.4487179487,0.7051282051,0.25,0.4871794872,12,12,12,12,0,0,0,0,2,1,1,78,77,77,78,1,0
116,122,7,7,0.5714285714,0.7142857143,0,7,0.7840909091,0.8409090909,0.5714285714,0.7840909091,7,7,7,7,0,0,0,0,2,1,1,74,88,74,88,14,0
507,516,10,14,0.1428571429,0.1428571429,4,12,0.4189189189,0.6351351351,0.1428571429,0.527027027,14,10,10,14,4,0,0,0,2,1,1,74,59,59,74,15,0
28,35,8,8,1,1,0,8,1,1,1,1,8,8,8,8,0,4,4,8,2,1,1,116,116,116,116,0,0
123,130,8,9,0.4444444444,0.8888888889,1,8.5,0.725,0.85,0.7777777778,0.825,9,8,8,9,1,0,0,0,2,1,1,40,34,34,40,6,0
1400,1417,18,20,0.5,0.85,2,19,0.8154761905,0.9047619048,0.35,0.755952381,20,18,18,20,2,0,0,0,2,1,1,168,155,155,168,13,0
37,63,27,27,0,0,0,27,0.2307692308,0.3846153846,0,0.3846153846,27,27,27,27,0,0,0,0,1,0,1,351,135,135,351,216,0
612,622,11,11,0,1,0,11,0.5714285714,1,1,1,11,11,11,11,0,0,0,0,2,1,1,77,77,77,77,0,0
299,315,17,17,1,1,0,17,1,1,1,1,17,17,17,17,0,0,0,0,2,1,1,114,114,114,114,0,0
155,326,172,172,0.9238095238,0.980952381,0,172,0.9762900976,0.9944211994,0.6666666667,0.9288702929,105,105,105,105,0,2,2,4,2,1,1,717,713,713,717,4,0
1109,1275,84,167,0,0,83,125.5,0.25,0.5,0,0.5,84,84,84,84,0,0,0,0,1,1,0,588,672,588,672,84,0
310,333,24,24,0,0,0,24,0.4444444444,0.6666666667,0,0.6666666667,24,24,24,24,0,0,0,0,2,1,1,216,168,168,216,48,0
349,378,30,30,0,0,0,30,0.1904761905,0.2857142857,0,0.2380952381,30,30,30,30,0,0,0,0,2,1,1,630,210,210,630,420,0
426,452,27,27,0.56,0.96,0,27,0.832460733,0.8952879581,0.96,0.890052356,25,25,25,25,0,1,1,2,4,2,2,191,174,174,191,17,0
11,44,34,34,1,1,0,34,1,1,1,1,31,31,31,31,0,0,0,0,0,0,0,365,365,365,365,0,1
160,176,17,17,1,1,0,17,1,1,1,1,27,27,27,27,0,0,0,0,2,1,1,251,251,251,251,0,0
505,511,7,7,0.7777777778,0.8888888889,0,7,0.9784946237,0.9892473118,0.8888888889,0.9892473118,9,9,9,9,0,3,3,6,2,1,1,93,93,93,93,0,1
127,156,14,30,0.1,0.1333333333,16,22,0.2270531401,0.4009661836,0.1,0.270531401,14,30,14,30,16,0,0,0,2,1,1,108,207,108,207,99,0
1166,1171,6,6,1,1,0,6,1,1,1,1,5,5,5,5,0,1,1,2,2,1,1,48,48,48,48,0,1
93,119,27,51,0.137254902,0.2156862745,24,39,0.3225,0.5075,0.137254902,0.3575,51,27,27,51,24,0,0,0,2,1,1,400,259,259,400,141,0
127,160,14,34,0.0882352941,0.1176470588,20,24,0.1713286713,0.2587412587,0.0882352941,0.1888111888,14,34,14,34,20,0,0,0,2,1,1,91,286,91,286,195,0
90,106,17,17,0.7368421053,1,0,17,0.9698795181,1,1,1,19,19,19,19,0,1,1,2,2,1,1,166,166,166,166,0,0
54,98,45,45,1,1,0,45,1,1,1,1,23,23,23,23,0,0,0,0,0,0,0,198,198,198,198,0,0
411,420,10,10,0.2,0.4,0,10,0.3095238095,0.5119047619,0.2,0.3571428571,10,10,10,10,0,0,0,0,2,1,1,84,56,56,84,28,0
994,1004,11,11,1,1,0,11,1,1,1,1,10,10,10,10,0,1,1,2,2,1,1,94,94,94,94,0,0
417,448,32,32,1,1,0,32,1,1,1,1,32,32,32,32,0,0,0,0,2,1,1,224,224,224,224,0,0
126,145,20,20,1,1,0,20,1,1,1,1,22,22,22,22,0,3,3,6,2,1,1,199,199,199,199,0,0
522,544,18,23,0.68,0.72,5,20.5,0.7165775401,0.7326203209,0.32,0.5989304813,20,25,20,25,5,0,0,0,2,1,1,137,187,137,187,50,0
139,154,16,17,1,1,1,16.5,1,1,1,1,12,12,12,12,0,0,0,0,4,2,2,111,111,111,111,0,0
86,98,13,14,0.2857142857,0.3571428571,1,13.5,0.350877193,0.5175438596,0.2857142857,0.3859649123,14,13,13,14,1,0,0,0,2,1,1,88,114,88,114,26,0
228,237,10,10,0.5,0.7,0,10,0.6417910448,0.7462686567,0.5,0.6119402985,10,10,10,10,0,0,0,0,2,1,1,61,67,61,67,6,0
188,204,11,17,0.1111111111,0.1666666667,6,14,0.3444444444,0.5222222222,0.1111111111,0.3888888889,11,18,11,18,7,0,0,0,2,1,1,80,90,80,90,10,0
349,379,31,31,1,1,0,31,1,1,1,1,31,31,31,31,0,0,0,0,2,1,1,393,393,393,393,0,1
395,411,14,17,0.1764705882,0.2352941176,3,15.5,0.3613445378,0.5882352941,0.1764705882,0.4537815126,14,17,14,17,3,0,0,0,2,1,1,90,119,90,119,29,0
137,162,26,26,0.9230769231,1,0,26,0.9810126582,1,1,1,26,26,26,26,0,2,2,4,2,1,1,158,158,158,158,0,0
509,515,7,7,0.5714285714,0.8571428571,0,7,0.8815789474,0.9342105263,0.5714285714,0.8289473684,7,7,7,7,0,0,0,0,2,1,1,73,76,73,76,3,1
313,337,14,25,0.12,0.12,11,19.5,0.3154362416,0.5369127517,0.12,0.3758389262,14,25,14,25,11,0,0,0,2,1,1,149,136,136,149,13,0
925,937,11,13,0.5384615385,0.8461538462,2,12,0.7933884298,0.867768595,0.3076923077,0.7107438017,11,13,11,13,2,0,0,0,2,1,1,105,121,105,121,16,0
424,433,10,12,0.5,0.7142857143,2,11,0.6153846154,0.75,0.3571428571,0.5961538462,14,12,12,14,2,0,0,0,2,1,1,104,82,82,104,22,0
792,802,1,11,0,0,10,6,0.537037037,0.6944444444,0,0.6851851852,8,11,8,11,3,0,0,0,2,1,1,108,87,87,108,21,0
509,513,5,5,0.8571428571,0.8571428571,0,5,0.9722222222,0.9722222222,0.8571428571,0.9722222222,7,7,7,7,0,2,2,4,2,1,1,72,71,71,72,1,1
332,341,10,10,0.9,0.9,0,10,0.9579831933,0.9579831933,0.9,0.9579831933,10,10,10,10,0,0,0,0,2,1,1,115,119,115,119,4,0
790,801,12,12,0.5833333333,0.9166666667,0,12,0.8571428571,0.9579831933,0.3333333333,0.7647058824,12,12,12,12,0,0,0,0,2,1,1,119,115,115,119,4,0
265,281,9,17,0.1764705882,0.1764705882,8,13,0.4210526316,0.5789473684,0.1764705882,0.4736842105,10,17,10,17,7,0,0,0,4,1,3,70,76,70,76,6,0
260,280,21,36,0.1111111111,0.2222222222,15,28.5,0.2888888889,0.4533333333,0.1111111111,0.3288888889,36,21,21,36,15,0,0,0,2,1,1,225,131,131,225,94,0
1668,1683,16,16,1,1,0,16,1,1,1,1,15,15,15,15,0,1,1,2,2,1,1,162,162,162,162,0,0
457,497,41,41,1,1,0,41,1,1,1,1,41,41,41,41,0,0,0,0,2,1,1,287,287,287,287,0,0
546,568,18,23,0.68,0.72,5,20.5,0.7165775401,0.7326203209,0.32,0.5989304813,20,25,20,25,5,0,0,0,2,1,1,137,187,137,187,50,0
158,177,20,26,0.2307692308,0.2692307692,6,23,0.2878787879,0.4292929293,0.2307692308,0.3131313131,26,20,20,26,6,0,0,0,2,1,1,198,111,111,198,87,0
458,488,31,31,1,1,0,31,1,1,1,1,31,31,31,31,0,0,0,0,2,1,1,217,217,217,217,0,0
432,441,10,16,0.125,0.1875,6,13,0.3613445378,0.5882352941,0.125,0.3613445378,16,10,10,16,6,0,0,0,2,1,1,119,108,108,119,11,0
748,758,10,11,0.7692307692,0.7692307692,1,10.5,0.8282828283,0.8585858586,0.2307692308,0.6464646465,12,13,12,13,1,0,0,0,2,1,1,87,99,87,99,12,0
362,565,204,204,1,1,0,204,1,1,1,1,197,197,197,197,0,1,1,2,4,2,2,1834,1834,1834,1834,0,0
90,100,11,16,0.1875,0.1875,5,13.5,0.3406593407,0.4945054945,0.1875,0.4065934066,16,11,11,16,5,0,0,0,2,1,1,91,58,58,91,33,0
522,544,18,23,0.68,0.72,5,20.5,0.7165775401,0.7326203209,0.32,0.5989304813,20,25,20,25,5,0,0,0,2,1,1,137,187,137,187,50,0
368,391,24,24,1,1,0,24,1,1,1,1,24,24,24,24,0,0,0,0,2,1,1,168,168,168,168,0,0
929,941,13,13,0.8461538462,1,0,13,0.9805825243,1,1,1,13,13,13,13,0,2,2,4,2,1,1,103,103,103,103,0,0
218,268,51,51,1,1,0,51,1,1,1,1,48,48,48,48,0,1,1,2,4,2,2,322,322,322,322,0,0
487,510,24,24,1,1,0,24,1,1,1,1,24,24,24,24,0,0,0,0,2,1,1,168,168,168,168,0,0
1,596,596,596,1,1,0,596,1,1,1,1,544,544,544,544,0,0,0,0,0,0,0,5073,5073,5073,5073,0,1
626,651,26,26,0.8518518519,0.962962963,0,26,0.9651741294,0.9850746269,0.7407407407,0.9004975124,27,27,27,27,0,1,1,2,4,2,2,198,201,198,201,3,0
1138,1153,16,19,0.5789473684,0.7894736842,3,17.5,0.7530120482,0.8192771084,0.2631578947,0.7108433735,19,16,16,19,3,0,0,0,2,1,1,166,136,136,166,30,0
804,816,13,15,0.4,0.8,2,14,0.6993464052,0.7973856209,0.3333333333,0.6862745098,15,13,13,15,2,0,0,0,2,1,1,153,122,122,153,31,0
379,394,16,18,0.3333333333,0.8888888889,2,17,0.8162162162,0.9243243243,0.6666666667,0.8918918919,18,16,16,18,2,0,0,0,2,1,1,185,171,171,185,14,0
63,90,28,28,0.8387096774,1,0,28,0.9805447471,1,1,1,31,31,31,31,0,1,1,2,2,1,1,257,257,257,257,0,0
268,285,15,18,0.1111111111,0.1666666667,3,16.5,0.3853211009,0.6055045872,0.1111111111,0.4403669725,15,18,15,18,3,0,0,0,3,1,2,109,97,97,109,12,0
955,967,11,13,0.5384615385,0.8461538462,2,12,0.7933884298,0.867768595,0.3076923077,0.7107438017,11,13,11,13,2,0,0,0,2,1,1,105,121,105,121,16,0
658,675,11,18,0.1666666667,0.2222222222,7,14.5,0.3181818182,0.5636363636,0.1666666667,0.3909090909,11,18,11,18,7,0,0,0,2,1,1,83,110,83,110,27,0
65,75,11,16,0.1875,0.1875,5,13.5,0.3536585366,0.5487804878,0.1875,0.4268292683,16,11,11,16,5,0,0,0,2,1,1,82,69,69,82,13,0
44,160,1,117,0,0.0099009901,116,59,0.1885813149,0.1903114187,0.0099009901,0.1903114187,1,101,1,101,100,0,3,3,1,0,1,330,1734,330,1734,1404,0
1604,1620,17,17,0.2352941176,0.3529411765,0,17,0.4193548387,0.5913978495,0.2352941176,0.4623655914,17,17,17,17,0,0,0,0,2,1,1,76,93,76,93,17,0
537,567,22,31,0.1612903226,0.1935483871,9,26.5,0.2763636364,0.4545454545,0.1612903226,0.3236363636,22,31,22,31,9,0,0,0,2,1,1,165,275,165,275,110,0
10,25,1,16,0.0714285714,0.0714285714,15,8.5,0.9615208429,0.9615208429,0.0714285714,0.9615208429,1,14,1,14,13,0,0,0,1,0,1,2099,2183,2099,2183,84,0
435,460,26,26,1,1,0,26,1,1,1,1,26,26,26,26,0,0,0,0,2,1,1,182,182,182,182,0,0
18,29,12,24,0.5,0.5,12,18,0.4953271028,0.4953271028,0.5,0.4953271028,24,12,12,24,12,0,0,0,0,0,0,214,106,106,214,108,0
531,540,10,10,0.3,0.7,0,10,0.515625,0.71875,0.6,0.65625,10,10,10,10,0,0,0,0,2,1,1,64,49,49,64,15,0
320,345,26,26,1,1,0,26,1,1,1,1,26,26,26,26,0,0,0,0,2,1,1,182,182,182,182,0,0
77,91,15,19,0.1578947368,0.3684210526,4,17,0.358974359,0.5726495726,0.2105263158,0.4188034188,19,15,15,19,4,0,0,0,2,1,1,117,88,88,117,29,0
76,85,10,10,0.1,0.7,0,10,0.5064935065,0.8311688312,0.1,0.5194805195,10,10,10,10,0,0,0,0,2,1,1,74,77,74,77,3,0
329,350,22,22,0,0,0,22,0.4285714286,0.5714285714,0,0.4415584416,22,22,22,22,0,0,0,0,2,1,1,110,154,110,154,44,0
324,349,26,26,1,1,0,26,1,1,1,1,26,26,26,26,0,0,0,0,2,1,1,182,182,182,182,0,0
161,172,12,12,0.25,0.25,0,12,0.3855421687,0.6385542169,0.25,0.4578313253,12,12,12,12,0,0,0,0,2,1,1,83,82,82,83,1,0
31,43,13,21,0.1304347826,0.1304347826,8,17,0.3253012048,0.5240963855,0.1304347826,0.3734939759,23,13,13,23,10,0,0,0,2,1,1,166,135,135,166,31,0
335,352,18,38,0.1282051282,0.1538461538,20,28,0.3073394495,0.4724770642,0.0512820513,0.3348623853,39,19,19,39,20,0,0,0,2,1,1,218,148,148,218,70,0
224,250,21,27,0.1111111111,0.2222222222,6,24,0.4361702128,0.670212766,0.1111111111,0.4627659574,21,27,21,27,6,0,0,0,2,1,1,177,188,177,188,11,0
460,481,22,22,0,0,0,22,0.4444444444,0.6666666667,0,0.6666666667,22,22,22,22,0,0,0,0,2,1,1,198,154,154,198,44,0
409,432,24,24,1,1,0,24,1,1,1,1,24,24,24,24,0,0,0,0,2,1,1,168,168,168,168,0,1
300,318,19,22,0.0454545455,0.7727272727,3,20.5,0.387434555,0.6701570681,0.0454545455,0.4240837696,22,19,19,22,3,0,0,0,2,1,1,191,130,130,191,61,0
618,643,17,26,0.0384615385,0.1923076923,9,21.5,0.369047619,0.5654761905,0.0384615385,0.4047619048,17,26,17,26,9,0,0,0,2,1,1,139,168,139,168,29,0
694,713,15,20,0.15,0.2,5,17.5,0.3970588235,0.6544117647,0.15,0.4632352941,15,20,15,20,5,0,0,0,2,1,1,136,133,133,136,3,0
466,482,17,17,1,1,0,17,1,1,1,1,17,17,17,17,0,0,0,0,2,1,1,119,119,119,119,0,0
247,257,11,13,0.1538461538,0.2307692308,2,12,0.3516483516,0.5274725275,0.1538461538,0.4175824176,13,11,11,13,2,0,0,0,2,1,1,91,64,64,91,27,0
74,106,33,33,1,1,0,33,1,1,1,1,17,17,17,17,0,0,0,0,0,0,0,113,113,113,113,0,0
493,507,11,15,0.4375,0.5,4,13,0.8034682081,0.8554913295,0.125,0.6589595376,12,16,12,16,4,0,0,0,2,1,1,159,173,159,173,14,0
68,78,10,11,0.3636363636,0.6363636364,1,10.5,0.5531914894,0.7446808511,0.5454545455,0.6382978723,10,11,10,11,1,0,0,0,3,1,2,45,47,45,47,2,0
165,176,12,30,0.0666666667,0.1333333333,18,21,0.2037914692,0.4407582938,0.0666666667,0.2701421801,30,12,12,30,18,0,0,0,2,1,1,211,126,126,211,85,0
219,226,8,8,1,1,0,8,1,1,1,1,10,10,10,10,0,2,2,4,2,1,1,113,113,113,113,0,0
397,426,30,30,1,1,0,30,1,1,1,1,30,30,30,30,0,0,0,0,2,1,1,210,210,210,210,0,0
1420,1437,15,18,0.4444444444,0.8333333333,3,16.5,0.80625,0.86875,0.8333333333,0.86875,15,18,15,18,3,0,0,0,2,1,1,139,160,139,160,21,0
797,809,11,13,0.0714285714,0.2857142857,2,12,0.3214285714,0.6,0.0714285714,0.4357142857,11,14,11,14,3,0,0,0,2,1,1,102,140,102,140,38,0
765,773,8,9,0.7272727273,0.8181818182,1,8.5,0.76,0.84,0.6363636364,0.7866666667,10,11,10,11,1,0,0,0,2,1,1,65,75,65,75,10,1
105,116,12,12,1,1,0,12,1,1,1,1,12,12,12,12,0,0,0,0,2,1,1,106,106,106,106,0,1
522,544,23,23,1,1,0,23,1,1,1,1,25,25,25,25,0,0,0,0,2,1,1,187,187,187,187,0,1
908,914,7,7,0.7142857143,0.7142857143,0,7,0.8292682927,0.9024390244,0.2857142857,0.7804878049,7,7,7,7,0,0,0,0,2,1,1,37,41,37,41,4,1
215,226,12,15,0.8,0.8,3,13.5,0.8656716418,0.8656716418,0.7333333333,0.8507462687,15,12,12,15,3,0,0,0,2,1,1,67,58,58,67,9,1
35,50,16,20,0.8,0.8,4,18,0.7819548872,0.7819548872,0.55,0.7443609023,20,16,16,20,4,0,0,0,2,1,1,133,104,104,133,29,1
416,439,24,24,1,1,0,24,1,1,1,1,24,24,24,24,0,1,1,2,2,1,1,131,131,131,131,0,1
159,173,15,15,1,1,0,15,1,1,1,1,15,15,15,15,0,0,0,0,2,1,1,190,190,190,190,0,1
364,370,7,7,0.2857142857,0.7142857143,0,7,0.6818181818,0.8636363636,0.7142857143,0.8409090909,7,7,7,7,0,0,0,0,2,1,1,44,41,41,44,3,1
30,44,15,15,1,1,0,15,1,1,1,1,15,15,15,15,0,0,0,0,2,1,1,72,72,72,72,0,1
64,73,10,10,1,1,0,10,1,1,1,1,11,11,11,11,0,0,0,0,2,1,1,115,115,115,115,0,1
64,69,6,6,1,1,0,6,1,1,1,1,6,6,6,6,0,0,0,0,2,1,1,32,32,32,32,0,1
272,283,12,12,1,1,0,12,1,1,1,1,14,14,14,14,0,0,0,0,2,1,1,133,133,133,133,0,1
362,387,26,26,0,0,0,26,0.4444444444,0.6666666667,0,0.6666666667,26,26,26,26,0,0,0,0,1,0,1,234,182,182,234,52,0
355,384,30,30,1,1,0,30,1,1,1,1,30,30,30,30,0,0,0,0,2,1,1,210,210,210,210,0,0
95,105,11,14,0.1333333333,0.2,3,12.5,0.3372093023,0.5348837209,0.1333333333,0.4069767442,15,11,11,15,4,0,0,0,2,1,1,86,71,71,86,15,0
309,347,39,39,0.8974358974,0.8974358974,0,39,0.9506578947,0.9506578947,0.4615384615,0.7105263158,39,39,39,39,0,0,0,0,2,1,1,297,304,297,304,7,1
459,472,14,14,1,1,0,14,1,1,1,1,14,14,14,14,0,0,0,0,2,1,1,128,128,128,128,0,1
972,980,9,9,1,1,0,9,1,1,1,1,11,11,11,11,0,0,0,0,2,1,1,85,85,85,85,0,1
620,630,11,11,1,1,0,11,1,1,1,1,11,11,11,11,0,0,0,0,2,1,1,113,113,113,113,0,1
69,89,17,21,0.7619047619,0.7619047619,4,19,0.8175675676,0.8378378378,0.5714285714,0.7972972973,17,21,17,21,4,0,0,0,2,1,1,125,148,125,148,23,1
853,875,22,23,0.6956521739,0.8695652174,1,22.5,0.8784313725,0.9490196078,0.1739130435,0.7411764706,22,23,22,23,1,0,0,0,2,1,1,255,252,252,255,3,1
721,729,9,9,0.6363636364,0.7272727273,0,9,0.6666666667,0.7466666667,0.4545454545,0.56,11,11,11,11,0,0,0,0,2,1,1,64,75,64,75,11,1
334,353,17,20,0.45,0.85,3,18.5,0.7660550459,0.8073394495,0.8,0.8027522936,17,20,17,20,3,0,0,0,2,1,1,176,218,176,218,42,1
414,423,10,10,1,1,0,10,1,1,1,1,10,10,10,10,0,0,0,0,2,1,1,44,44,44,44,0,1
196,329,134,134,0.992248062,0.992248062,0,134,0.9930348259,0.9950248756,0.2093023256,0.7084577114,129,129,129,129,0,1,1,2,4,2,2,1005,1000,1000,1005,5,0
546,568,23,23,1,1,0,23,1,1,1,1,25,25,25,25,0,0,0,0,2,1,1,187,187,187,187,0,1
862,888,27,27,1,1,0,27,1,1,1,1,18,18,18,18,0,1,1,2,4,2,2,160,160,160,160,0,1
519,547,29,29,1,1,0,29,1,1,1,1,31,31,31,31,0,0,0,0,2,1,1,306,306,306,306,0,1
917,931,13,15,0.6666666667,0.8,2,14,0.8159509202,0.8527607362,0.2,0.6073619632,13,15,13,15,2,4,4,8,2,1,1,139,163,139,163,24,1
21,33,13,13,1,1,0,13,1,1,1,1,14,14,14,14,0,1,1,2,2,1,1,90,90,90,90,0,1
143,171,29,29,0,1,0,29,0.6666666667,1,1,1,29,29,29,29,0,0,0,0,1,0,1,261,261,261,261,0,0
53,55,3,3,0,0.6666666667,0,3,0.75,0.9230769231,0.6666666667,0.9038461538,3,3,3,3,0,0,0,0,2,1,1,48,52,48,52,4,0
322,360,39,39,1,1,0,39,1,1,1,1,39,39,39,39,0,0,0,0,2,1,1,296,296,296,296,0,1
945,995,51,51,0,1,0,51,0.5,1,0.1153846154,0.7788461538,26,26,26,26,0,0,0,0,0,0,0,208,208,208,208,0,0
744,754,10,11,0.5384615385,0.6923076923,1,10.5,0.7070707071,0.7878787879,0.3076923077,0.6060606061,12,13,12,13,1,0,0,0,2,1,1,90,99,90,99,9,0
99,111,13,13,1,1,0,13,1,1,1,1,13,13,13,13,0,0,0,0,2,1,1,117,117,117,117,0,1
383,392,10,10,0.7,1,0,10,0.9690721649,1,1,1,10,10,10,10,0,1,1,2,2,1,1,97,97,97,97,0,0
298,353,56,56,1,1,0,56,1,1,1,1,58,58,58,58,0,0,0,0,2,1,1,597,597,597,597,0,1
110,197,88,88,1,1,0,88,1,1,1,1,88,88,88,88,0,0,0,0,2,1,1,484,484,484,484,0,1
213,241,29,29,1,1,0,29,1,1,1,1,28,28,28,28,0,1,1,2,2,1,1,196,196,196,196,0,0
425,435,11,11,0.3636363636,1,0,11,0.95,1,1,1,11,11,11,11,0,3,3,6,2,1,1,180,180,180,180,0,1
193,199,7,8,0.5,0.875,1,7.5,0.4807692308,0.5576923077,0.5,0.5192307692,8,7,7,8,1,0,0,0,2,1,1,52,29,29,52,23,0
89,96,8,8,0.75,1,0,8,0.8888888889,1,1,1,8,8,8,8,0,0,0,0,2,1,1,45,45,45,45,0,1
456,465,10,10,0.8,0.8,0,10,0.82,0.86,0.4,0.66,10,10,10,10,0,0,0,0,2,1,1,44,50,44,50,6,1
84,95,12,12,1,1,0,12,1,1,1,1,12,12,12,12,0,0,0,0,2,1,1,100,100,100,100,0,1
535,544,9,10,0.5833333333,0.75,1,9.5,0.743902439,0.8170731707,0.25,0.6219512195,11,12,11,12,1,0,0,0,2,1,1,78,82,78,82,4,1
213,228,16,16,1,1,0,16,1,1,1,1,16,16,16,16,0,0,0,0,2,1,1,106,106,106,106,0,1
4,201,198,198,1,1,0,198,1,1,1,1,181,181,181,181,0,3,3,6,2,1,1,1533,1533,1533,1533,0,1
71,110,40,40,0.8,0.8,0,40,0.7105263158,0.7368421053,0.425,0.5605263158,40,40,40,40,0,0,0,0,2,1,1,280,380,280,380,100,1
159,181,23,23,1,1,0,23,1,1,1,1,25,25,25,25,0,0,0,0,2,1,1,202,202,202,202,0,1
222,237,16,16,0.8823529412,0.8823529412,0,16,0.8608695652,0.8608695652,0.3529411765,0.6782608696,16,17,16,17,1,1,1,2,2,1,1,99,115,99,115,16,1
347,357,11,14,0.6875,0.6875,3,12.5,0.6229508197,0.6557377049,0.3125,0.4918032787,16,13,13,16,3,0,0,0,2,1,1,122,91,91,122,31,0
209,264,39,56,0.5789473684,0.5789473684,17,47.5,0.708249497,0.7162977867,0.1578947368,0.5352112676,40,57,40,57,17,0,0,0,2,1,1,376,497,376,497,121,1
257,270,14,14,0.8125,0.9375,0,14,0.9672131148,0.9918032787,0.9375,0.9918032787,16,16,16,16,0,0,0,0,2,1,1,122,122,122,122,0,1
138,146,9,9,1,1,0,9,1,1,1,1,9,9,9,9,0,1,1,2,2,1,1,97,97,97,97,0,1
580,599,20,20,0.9523809524,0.9523809524,0,20,0.9912280702,0.9912280702,0.9523809524,0.9912280702,21,21,21,21,0,0,0,0,2,1,1,114,114,114,114,0,1
234,245,11,12,0.75,0.9166666667,1,11.5,0.8728813559,0.8898305085,0.9166666667,0.8898305085,11,12,11,12,1,0,0,0,2,1,1,105,118,105,118,13,1
490,513,24,24,0.9583333333,0.9583333333,0,24,0.9898477157,0.9898477157,0.9583333333,0.9898477157,24,24,24,24,0,1,2,3,2,1,1,195,197,195,197,2,1
74,83,8,10,0.3,0.7,2,9,0.5769230769,0.7692307692,0.5,0.7115384615,8,10,8,10,2,0,0,0,2,1,1,52,49,49,52,3,0
160,176,17,17,1,1,0,17,1,1,1,1,17,17,17,17,0,1,1,2,2,1,1,97,97,97,97,0,1
324,334,11,11,0.9090909091,1,0,11,0.9824561404,1,1,1,11,11,11,11,0,0,0,0,2,1,1,57,57,57,57,0,1
32,41,10,11,0.3636363636,0.7272727273,1,10.5,0.8219178082,0.904109589,0.7272727273,0.8904109589,11,10,10,11,1,0,0,0,2,1,1,146,138,138,146,8,1
152,157,6,6,0.7142857143,0.8571428571,0,6,0.8405797101,0.884057971,0.2857142857,0.6231884058,7,7,7,7,0,1,1,2,2,1,1,69,61,61,69,8,1
1532,1546,14,15,0.6,0.8666666667,1,14.5,0.8759689922,0.9302325581,0.3333333333,0.7984496124,14,15,14,15,1,0,0,0,2,1,1,122,129,122,129,7,1
360,369,10,11,0.4545454545,0.5454545455,1,10.5,0.5735294118,0.7058823529,0.3636363636,0.5441176471,11,10,10,11,1,0,0,0,2,1,1,68,62,62,68,6,1
345,376,32,32,1,1,0,32,1,1,1,1,32,32,32,32,0,0,0,0,2,1,1,224,224,224,224,0,0
48,51,4,9,0,0,5,6.5,0.406779661,0.6101694915,0,0.5593220339,9,4,4,9,5,0,1,1,2,1,1,59,58,58,59,1,0
186,192,7,7,0.625,0.875,0,7,0.8481012658,0.8987341772,0.25,0.6455696203,8,8,8,8,0,0,0,0,2,1,1,79,71,71,79,8,1
1177,1185,9,9,1,1,0,9,1,1,1,1,9,9,9,9,0,2,2,4,2,1,1,63,63,63,63,0,1
23,63,41,41,1,1,0,41,1,1,1,1,39,39,39,39,0,0,0,0,0,0,0,397,397,397,397,0,1
1171,1180,10,15,0.2,0.2666666667,5,12.5,0.3529411765,0.5294117647,0.2,0.3921568627,15,11,11,15,4,0,0,0,2,1,1,102,75,75,102,27,0
32,38,7,7,0.7142857143,0.7142857143,0,7,0.7058823529,0.7058823529,0.7142857143,0.6911764706,7,7,7,7,0,0,0,0,2,1,1,68,52,52,68,16,1
64,71,8,9,0.5555555556,0.6666666667,1,8.5,0.8387096774,0.8548387097,0.6666666667,0.8548387097,9,9,9,9,0,0,0,0,2,1,1,62,62,62,62,0,1
650,667,18,18,0.9,1,0,18,0.9854014599,1,1,1,20,20,20,20,0,0,0,0,2,1,1,137,137,137,137,0,1
476,497,22,22,1,1,0,22,1,1,1,1,22,22,22,22,0,0,0,0,2,1,1,154,154,154,154,0,1
21,39,19,49,0,0.4375,30,34,0.3707865169,0.606741573,0.0625,0.404494382,16,11,11,16,5,2,1,3,2,1,1,89,59,59,89,30,0
263,272,10,10,0.4,0.7,0,10,0.5777777778,0.6888888889,0.6,0.6444444444,10,10,10,10,0,0,0,0,2,1,1,39,45,39,45,6,0
910,925,16,17,0.0588235294,0.7647058824,1,16.5,0.4779411765,0.8014705882,0.0588235294,0.5,17,16,16,17,1,0,0,0,2,1,1,136,113,113,136,23,0
225,236,12,14,0.7142857143,0.7857142857,2,13,0.754491018,0.7664670659,0.5,0.7245508982,14,12,12,14,2,0,0,0,2,1,1,167,128,128,167,39,0
377,387,11,11,0.9166666667,1,0,11,0.9885057471,1,1,1,12,12,12,12,0,0,0,0,2,1,1,87,87,87,87,0,1
925,936,12,17,0.3076923077,0.4615384615,5,14.5,0.4776119403,0.5671641791,0.3076923077,0.4776119403,13,13,13,13,0,1,3,4,3,2,1,59,67,59,67,8,0
90,96,7,7,0.7142857143,0.8571428571,0,7,0.8863636364,0.9090909091,0.5714285714,0.8181818182,7,7,7,7,0,0,0,0,2,1,1,44,40,40,44,4,0
643,662,20,20,0.8571428571,1,0,20,0.9806451613,1,1,1,21,21,21,21,0,1,1,2,4,2,2,155,155,155,155,0,1
56,63,8,8,0.5,0.75,0,8,0.9154929577,0.9436619718,0.75,0.9436619718,8,8,8,8,0,0,0,0,2,1,1,71,67,67,71,4,1
10,41,1,32,0.0384615385,0.0384615385,31,16.5,0.9333036905,0.9333036905,0.0384615385,0.9333036905,1,26,1,26,25,0,1,1,0,0,0,2099,2249,2099,2249,150,0
115,126,9,12,0.1666666667,0.3333333333,3,10.5,0.3965517241,0.5689655172,0.1666666667,0.4310344828,9,12,9,12,3,2,1,3,2,1,1,58,57,57,58,1,0
272,296,12,25,0.12,0.2,13,18.5,0.2625698324,0.3966480447,0.12,0.2625698324,12,25,12,25,13,0,0,0,2,1,1,84,179,84,179,95,0
59,72,14,20,0.05,0.2,6,17,0.380952381,0.6111111111,0.05,0.4444444444,20,14,14,20,6,0,0,0,2,1,1,126,105,105,126,21,0
10,1556,1,1547,0.0384615385,0.0384615385,1546,774,0.9333036905,0.9333036905,0.0384615385,0.9333036905,1,26,1,26,25,0,1,1,0,0,0,2099,2249,2099,2249,150,0
346,360,15,15,0.3333333333,0.6,0,15,0.6323529412,0.8382352941,0.6,0.8382352941,15,15,15,15,0,0,1,1,2,1,1,60,68,60,68,8,0
459,472,13,14,0.7142857143,0.7857142857,1,13.5,0.8796992481,0.9172932331,0.5714285714,0.7969924812,13,14,13,14,1,0,0,0,2,1,1,133,128,128,133,5,1
62,78,17,17,0.7368421053,0.9473684211,0,17,0.9212121212,0.9515151515,0.9473684211,0.9454545455,19,19,19,19,0,1,0,1,2,1,1,165,159,159,165,6,0
618,627,9,10,0,0.7,1,9.5,0.8873239437,0.9577464789,0.7,0.9436619718,9,10,9,10,1,1,1,2,2,1,1,142,140,140,142,2,0
188,195,8,8,0.75,1,0,8,0.9777777778,1,0.875,0.9888888889,8,8,8,8,0,0,0,0,2,1,1,90,90,90,90,0,1
79,90,12,14,0.2142857143,0.3571428571,2,13,0.4489795918,0.7040816327,0.2142857143,0.4897959184,14,12,12,14,2,0,0,0,2,1,1,87,98,87,98,11,0
271,379,105,109,1,1,4,107,1,1,1,1,43,43,43,43,0,1,1,2,4,2,2,280,280,280,280,0,0
684,694,10,11,0.5384615385,0.7692307692,1,10.5,0.7070707071,0.8080808081,0.3076923077,0.6363636364,12,13,12,13,1,0,0,0,2,1,1,86,99,86,99,13,0
599,605,7,7,0.4285714286,0.7142857143,0,7,0.511627907,0.7674418605,0.4285714286,0.5813953488,7,7,7,7,0,0,0,0,2,1,1,39,43,39,43,4,0
1,36,36,36,0.9696969697,1,0,36,0.9959839357,1,1,1,33,33,33,33,0,0,0,0,0,0,0,249,249,249,249,0,0
432,435,4,9,0,0,5,6.5,0.25,0.4047619048,0,0.3095238095,8,4,4,8,4,1,1,2,3,2,1,84,60,60,84,24,0
334,353,17,20,0.4,0.8,3,18.5,0.752293578,0.8302752294,0.2,0.6788990826,17,20,17,20,3,0,0,0,2,1,1,182,218,182,218,36,0
99,240,142,142,0.953271028,0.953271028,0,142,0.9366925065,0.9457364341,0.4205607477,0.7235142119,107,107,107,107,0,1,1,2,4,2,2,732,774,732,774,42,0
98,130,33,37,0.64,0.96,4,35,0.8867924528,0.9905660377,0.4,0.7547169811,25,25,25,25,0,1,1,2,4,2,2,106,106,106,106,0,0
183,616,434,434,0.4285714286,0.6267281106,0,434,0.75,0.7957983193,0.0092165899,0.5911764706,434,380,380,434,54,1,1,2,2,1,1,2380,1894,1894,2380,486,1
73,108,28,36,0.5714285714,0.5714285714,8,32,0.847826087,0.8804347826,0.5714285714,0.847826087,7,7,7,7,0,1,1,2,4,2,2,92,82,82,92,10,0
419,425,7,7,0.75,1,0,7,0.9718309859,1,1,1,8,8,8,8,0,0,0,0,2,1,1,71,71,71,71,0,1
667,677,11,11,0.4,0.8,0,11,0.5471698113,0.6509433962,0.4,0.4905660377,10,10,10,10,0,0,0,0,4,2,2,106,80,80,106,26,1
208,211,4,4,0.75,0.75,0,4,0.75,0.9342105263,0.75,0.8684210526,4,4,4,4,0,0,0,0,2,1,1,74,76,74,76,2,1
408,422,13,15,0.4,0.8,2,14,0.6993464052,0.7908496732,0.2666666667,0.6535947712,13,15,13,15,2,0,0,0,2,1,1,121,153,121,153,32,1
367,379,13,13,1,1,0,13,1,1,1,1,13,13,13,13,0,0,0,0,2,1,1,124,124,124,124,0,1
21,94,74,74,0.9583333333,0.9791666667,0,74,0.9816091954,0.9885057471,0.9791666667,0.9862068966,48,48,48,48,0,1,1,2,0,0,0,431,435,431,435,4,0
1534,1548,15,15,1,1,0,15,1,1,1,1,14,14,14,14,0,1,1,2,2,1,1,118,118,118,118,0,1
572,580,9,9,0.4444444444,1,0,9,0.8305084746,1,1,1,9,9,9,9,0,1,1,2,2,1,1,59,59,59,59,0,1
34,39,6,6,0.8333333333,0.8333333333,0,6,0.7368421053,0.7368421053,0.5,0.6666666667,6,6,6,6,0,0,0,0,2,1,1,42,57,42,57,15,1
1365,1374,10,10,1,1,0,10,1,1,1,1,11,11,11,11,0,0,0,0,2,1,1,73,73,73,73,0,1
21,30,10,10,1,1,0,10,1,1,1,1,12,12,12,12,0,0,0,0,2,1,1,121,121,121,121,0,1
403,432,30,30,0,0,0,30,0.4285714286,0.5714285714,0,0.4380952381,30,30,30,30,0,0,0,0,2,1,1,150,210,150,210,60,0
385,389,5,6,0.4285714286,0.5714285714,1,5.5,0.5593220339,0.6949152542,0.2857142857,0.6271186441,7,6,6,7,1,3,2,5,2,1,1,59,43,43,59,16,0
50,67,18,30,0.1,0.2,12,24,0.3227513228,0.5132275132,0.1666666667,0.3915343915,30,18,18,30,12,0,0,0,2,1,1,189,149,149,189,40,0
328,340,9,13,0.1538461538,0.4615384615,4,11,0.6923076923,0.8461538462,0.4615384615,0.8461538462,9,13,9,13,4,1,1,2,2,1,1,52,49,49,52,3,0
907,920,14,14,0.4285714286,0.8571428571,0,14,0.8009259259,0.9444444444,0,0.75,14,14,14,14,0,0,0,0,2,1,1,216,212,212,216,4,1
81,91,11,12,0.3076923077,0.4615384615,1,11.5,0.6138613861,0.6930693069,0.2307692308,0.504950495,13,12,12,13,1,0,0,0,2,1,1,101,89,89,101,12,0
402,418,17,17,1,1,0,17,1,1,1,1,17,17,17,17,0,0,0,0,2,1,1,119,119,119,119,0,1
658,677,20,20,0.9047619048,0.9047619048,0,20,0.9495798319,0.9495798319,0.2857142857,0.6974789916,21,21,21,21,0,0,0,0,2,1,1,119,114,114,119,5,1
406,429,24,24,1,1,0,24,1,1,1,1,24,24,24,24,0,0,0,0,2,1,1,168,168,168,168,0,0
131,153,23,23,1,1,0,23,1,1,1,1,25,25,25,25,0,0,0,0,2,1,1,202,202,202,202,0,1
170,175,6,6,0.8571428571,1,0,6,0.9830508475,1,1,1,7,7,7,7,0,1,1,2,2,1,1,59,59,59,59,0,1
251,269,19,21,0.0476190476,0.8095238095,2,20,0.5454545455,0.9090909091,0.0476190476,0.5524475524,21,19,19,21,2,0,0,0,2,1,1,134,143,134,143,9,0
124,132,9,9,0.2857142857,0.5714285714,0,9,0.6102941176,0.7794117647,0.2857142857,0.6323529412,7,7,7,7,0,1,1,2,4,2,2,106,136,106,136,30,0
133,150,18,18,1,1,0,18,1,1,1,1,18,18,18,18,0,0,0,0,2,1,1,142,142,142,142,0,1
238,251,14,14,1,1,0,14,1,1,1,1,14,14,14,14,0,0,0,0,2,1,1,107,107,107,107,0,1
967,976,10,10,0.75,0.8333333333,0,10,0.8461538462,0.9010989011,0.3333333333,0.6923076923,12,12,12,12,0,0,0,0,2,1,1,82,91,82,91,9,1
1114,1133,20,20,1,1,0,20,1,1,1,1,16,16,16,16,0,3,3,6,4,2,2,117,117,117,117,0,0
1563,1591,16,29,0.1379310345,0.275862069,13,22.5,0.2597402597,0.3896103896,0.1724137931,0.3051948052,16,29,16,29,13,0,0,0,3,2,1,66,154,66,154,88,0
1070,1079,10,10,0.8333333333,0.9166666667,0,10,0.9111111111,0.9333333333,0.9166666667,0.9222222222,12,12,12,12,0,0,0,0,2,1,1,86,90,86,90,4,0
546,568,23,23,0.88,1,0,23,0.9786096257,1,1,1,25,25,25,25,0,0,0,0,2,1,1,187,187,187,187,0,1
327,340,14,21,0.1428571429,0.1904761905,7,17.5,0.2814371257,0.4431137725,0.1428571429,0.3413173653,21,14,14,21,7,0,0,0,2,1,1,167,95,95,167,72,0
533,543,11,11,0.9090909091,1,0,11,0.9914529915,1,1,1,11,11,11,11,0,1,1,2,4,2,2,117,117,117,117,0,1
856,882,27,27,0,0,0,27,0.3,0.5,0,0.5,27,27,27,27,0,0,0,0,1,1,0,189,270,189,270,81,0
69,89,17,21,0.7619047619,0.7619047619,4,19,0.8175675676,0.8378378378,0.5714285714,0.7972972973,17,21,17,21,4,0,0,0,2,1,1,125,148,125,148,23,0
371,396,26,26,1,1,0,26,1,1,1,1,26,26,26,26,0,0,0,0,2,1,1,182,182,182,182,0,0
133,146,12,14,0.4285714286,0.7857142857,2,13,0.7034482759,0.7655172414,0.3571428571,0.6689655172,12,14,12,14,2,0,0,0,2,1,1,112,145,112,145,33,1
78,82,5,5,0.6666666667,1,0,5,0.9677419355,1,1,1,6,6,6,6,0,2,2,4,2,1,1,62,62,62,62,0,1
275,299,20,25,0.1785714286,0.2142857143,5,22.5,0.2730263158,0.4243421053,0.1785714286,0.2927631579,20,28,20,28,8,0,0,0,2,1,1,157,304,157,304,147,0
434,441,8,9,0.2222222222,0.8888888889,1,8.5,0.6956521739,0.847826087,0.7777777778,0.847826087,9,8,8,9,1,0,0,0,2,1,1,46,39,39,46,7,1
446,451,6,6,0.8333333333,1,0,6,0.9701492537,1,1,1,6,6,6,6,0,0,0,0,2,1,1,67,67,67,67,0,1
31,42,12,12,0.5,0.75,0,12,0.9072164948,0.9381443299,0.75,0.9381443299,12,12,12,12,0,1,1,2,2,1,1,91,97,91,97,6,1
93,98,6,6,0,0.1666666667,0,6,0.453125,0.6875,0.1666666667,0.59375,6,6,6,6,0,1,0,1,2,1,1,55,64,55,64,9,0
142,173,32,32,1,1,0,32,1,1,1,1,33,33,33,33,0,0,0,0,2,1,1,235,235,235,235,0,1
1207,1216,10,10,1,1,0,10,1,1,1,1,10,10,10,10,0,0,0,0,2,1,1,61,61,61,61,0,1
31,54,24,24,1,1,0,24,1,1,1,1,24,24,24,24,0,0,0,0,2,1,1,164,164,164,164,0,1
1128,1141,12,14,0.5714285714,0.7857142857,2,13,0.8017241379,0.8620689655,0.7142857143,0.8275862069,12,14,12,14,2,0,0,0,2,1,1,101,116,101,116,15,1
204,208,5,5,0.8333333333,0.8333333333,0,5,0.9692307692,0.9846153846,0.8333333333,0.9846153846,6,6,6,6,0,1,1,2,2,1,1,65,65,65,65,0,1
583,590,8,8,0.8888888889,1,0,8,0.9807692308,1,1,1,9,9,9,9,0,1,1,2,2,1,1,52,52,52,52,0,1
16,219,204,204,0.904109589,1,0,204,0.9800995025,1,1,1,73,73,73,73,0,0,0,0,0,0,0,402,402,402,402,0,1
1,19,19,19,1,1,0,19,1,1,1,1,17,17,17,17,0,0,0,0,0,0,0,159,159,159,159,0,1
130,136,7,7,0.5714285714,0.7142857143,0,7,0.5217391304,0.6304347826,0.5714285714,0.5434782609,7,7,7,7,0,0,0,0,2,1,1,29,46,29,46,17,0
238,247,10,10,0.4,0.6,0,10,0.4736842105,0.6666666667,0.4,0.5087719298,10,10,10,10,0,0,0,0,2,1,1,54,57,54,57,3,0
186,192,6,7,0.4285714286,0.7142857143,1,6.5,0.6785714286,0.8928571429,0.5714285714,0.7857142857,6,7,6,7,1,0,0,0,2,1,1,28,27,27,28,1,0
546,568,21,23,0.84,0.88,2,22,0.8395721925,0.871657754,0.68,0.807486631,23,25,23,25,2,0,0,0,2,1,1,166,187,166,187,21,1
222,236,14,15,0.4666666667,0.6,1,14.5,0.7852348993,0.8791946309,0.4,0.744966443,14,15,14,15,1,0,0,0,2,1,1,149,147,147,149,2,1
15,31,12,17,0,0.2222222222,5,14.5,0.5,0.84375,0.2222222222,0.640625,9,9,9,9,0,1,1,2,0,0,0,64,64,64,64,0,0
366,376,11,11,0.9090909091,0.9090909091,0,11,0.9805825243,0.9805825243,0.0909090909,0.6893203883,11,11,11,11,0,2,2,4,2,1,1,101,103,101,103,2,1
533,583,51,51,1,1,0,51,1,1,1,1,52,52,52,52,0,0,0,0,2,1,1,401,401,401,401,0,1
629,646,18,21,0.7391304348,0.7826086957,3,19.5,0.7951807229,0.813253012,0.347826087,0.656626506,23,20,20,23,3,0,0,0,2,1,1,166,137,137,166,29,1
149,157,9,9,1,1,0,9,1,1,1,1,11,11,11,11,0,0,0,0,2,1,1,105,105,105,105,0,1
95,105,11,11,1,1,0,11,1,1,1,1,13,13,13,13,0,1,1,2,2,1,1,122,122,122,122,0,1
312,327,14,16,0.125,0.125,2,15,0.3481481481,0.5333333333,0.125,0.4,14,16,14,16,2,0,0,0,2,1,1,135,109,109,135,26,0
256,263,8,8,0.75,1,0,8,0.9512195122,1,1,1,8,8,8,8,0,0,0,0,2,1,1,41,41,41,41,0,1
19,34,16,16,1,1,0,16,1,1,1,1,16,16,16,16,0,0,0,0,2,1,1,119,119,119,119,0,1
65,113,49,49,1,1,0,49,1,1,1,1,49,49,49,49,0,0,0,0,2,1,1,360,360,360,360,0,1
282,291,10,10,1,1,0,10,1,1,1,1,10,10,10,10,0,0,0,0,2,1,1,45,45,45,45,0,1
74,88,15,15,0.7058823529,0.9411764706,0,15,0.9108280255,0.949044586,0.2352941176,0.6687898089,17,17,17,17,0,0,0,0,2,1,1,157,149,149,157,8,0
294,306,12,13,0.5384615385,0.8461538462,1,12.5,0.7792207792,0.8311688312,0.5384615385,0.7727272727,12,13,12,13,1,0,0,0,2,1,1,128,154,128,154,26,1
599,607,9,11,0.6153846154,0.7692307692,2,10,0.7171717172,0.7474747475,0.3846153846,0.5757575758,13,11,11,13,2,0,0,0,2,1,1,99,75,75,99,24,1
163,168,6,6,0,0.3333333333,0,6,0.5714285714,0.9047619048,0,0.6666666667,6,6,6,6,0,0,0,0,2,1,1,42,42,42,42,0,0
76,89,14,14,0.8125,1,0,14,0.9781021898,1,1,1,16,16,16,16,0,1,1,2,2,1,1,137,137,137,137,0,1
281,297,17,24,0.2307692308,0.2307692308,7,20.5,0.3055555556,0.4722222222,0.2307692308,0.375,13,13,13,13,0,0,1,1,3,2,1,61,72,61,72,11,0
21,30,10,10,0.3,1,0,10,0.9326923077,1,1,1,10,10,10,10,0,0,0,0,2,1,1,104,104,104,104,0,0
531,544,14,14,0.8666666667,0.9333333333,0,14,0.9285714286,0.9523809524,0.5333333333,0.7976190476,15,15,15,15,0,2,3,5,2,1,1,80,84,80,84,4,1
371,379,9,9,1,1,0,9,1,1,1,1,9,9,9,9,0,0,0,0,2,1,1,51,51,51,51,0,1
910,922,13,13,0.6153846154,1,0,13,0.958677686,1,1,1,13,13,13,13,0,0,0,0,2,1,1,121,121,121,121,0,1
1098,1110,13,13,1,1,0,13,1,1,1,1,13,13,13,13,0,2,2,4,2,1,1,98,98,98,98,0,1
376,397,22,22,1,1,0,22,1,1,1,1,22,22,22,22,0,0,0,0,2,1,1,154,154,154,154,0,1
14,76,63,63,1,1,0,63,1,1,1,1,63,63,63,63,0,0,0,0,2,1,1,729,729,729,729,0,1
349,379,31,32,0.96875,0.96875,1,31.5,0.9874371859,0.9874371859,0.4375,0.743718593,32,31,31,32,1,0,0,0,2,1,1,398,393,393,398,5,1
39,52,14,14,0.7857142857,0.7857142857,0,14,0.850877193,0.8596491228,0.2142857143,0.6842105263,14,14,14,14,0,0,1,1,2,1,1,101,114,101,114,13,1
513,535,23,23,1,1,0,23,1,1,1,1,23,23,23,23,0,0,0,0,2,1,1,203,203,203,203,0,1
12,26,15,19,0.6315789474,0.6842105263,4,17,0.8173913043,0.8260869565,0.6842105263,0.8260869565,19,15,15,19,4,0,0,0,2,1,1,115,97,97,115,18,1
286,296,11,11,0.9166666667,0.9166666667,0,11,0.9846153846,0.9846153846,0.9166666667,0.9846153846,12,12,12,12,0,0,0,0,2,1,1,65,65,65,65,0,1
159,173,15,15,1,1,0,15,1,1,1,1,15,15,15,15,0,0,0,0,2,1,1,190,190,190,190,0,1
803,816,14,16,0.4375,0.8125,2,15,0.7032258065,0.8,0.375,0.6903225806,16,14,14,16,2,0,0,0,2,1,1,155,124,124,155,31,1
128,133,6,6,0.5714285714,0.8571428571,0,6,0.9322033898,0.9661016949,0.8571428571,0.9661016949,7,7,7,7,0,1,1,2,2,1,1,59,59,59,59,0,1
66,82,17,21,0.7619047619,0.7619047619,4,19,0.8175675676,0.8378378378,0.5714285714,0.7972972973,21,17,17,21,4,0,0,0,2,1,1,148,125,125,148,23,1
226,245,20,20,0.7,0.9,0,20,0.9104477612,0.9552238806,0.9,0.9552238806,10,10,10,10,0,1,1,2,4,2,2,65,67,65,67,2,1
398,427,26,30,0.3666666667,0.8666666667,4,28,0.7041564792,0.7506112469,0.6666666667,0.728606357,26,30,26,30,4,0,0,0,2,1,1,307,409,307,409,102,1
313,325,13,13,1,1,0,13,1,1,1,1,13,13,13,13,0,1,1,2,2,1,1,123,123,123,123,0,1
606,619,14,14,1,1,0,14,1,1,1,1,15,15,15,15,0,0,0,0,2,1,1,131,131,131,131,0,1
49,59,11,11,0.5833333333,0.9166666667,0,11,0.8860759494,0.9873417722,0.9166666667,0.9873417722,12,12,12,12,0,0,0,0,2,1,1,79,78,78,79,1,1
243,256,12,14,0.4285714286,0.5714285714,2,13,0.6547619048,0.7023809524,0.2142857143,0.5357142857,12,14,12,14,2,0,0,0,2,1,1,76,84,76,84,8,1
589,603,15,15,1,1,0,15,1,1,1,1,15,15,15,15,0,0,0,0,2,1,1,147,147,147,147,0,1
116,130,15,17,0.4117647059,0.7647058824,2,16,0.8021978022,0.8681318681,0.4705882353,0.8076923077,17,15,15,17,2,0,0,0,2,1,1,182,159,159,182,23,1
1496,1509,14,17,0.5294117647,0.7647058824,3,15.5,0.8028169014,0.8521126761,0.2941176471,0.7323943662,17,14,14,17,3,0,0,0,2,1,1,142,122,122,142,20,1
391,401,11,11,0.8333333333,0.8333333333,0,11,0.9411764706,0.9411764706,0.8333333333,0.9411764706,12,12,12,12,0,0,0,0,2,1,1,68,65,65,68,3,1
243,254,12,12,0.8333333333,0.9166666667,0,12,0.8522727273,0.875,0.3333333333,0.6363636364,12,12,12,12,0,1,1,2,2,1,1,88,77,77,88,11,1
1049,1062,14,14,0.8,0.8,0,14,0.9037037037,0.9037037037,0.2,0.637037037,15,15,15,15,0,0,0,0,2,1,1,135,125,125,135,10,1
31,46,16,16,1,1,0,16,1,1,1,1,16,16,16,16,0,0,0,0,2,1,1,159,159,159,159,0,1
631,648,18,23,0.68,0.72,5,20.5,0.7165775401,0.7326203209,0.32,0.5989304813,25,20,20,25,5,0,0,0,2,1,1,187,137,137,187,50,1
363,373,11,11,0.5454545455,1,0,11,0.8421052632,1,1,1,11,11,11,11,0,0,0,0,2,1,1,57,57,57,57,0,1
76,100,25,25,0.8214285714,1,0,25,0.9794238683,1,1,1,28,28,28,28,0,1,1,2,2,1,1,243,243,243,243,0,1
661,677,17,17,0.1666666667,0.3333333333,0,17,0.5472972973,0.6081081081,0.1666666667,0.4391891892,24,13,13,24,11,1,1,2,4,2,2,148,90,90,148,58,1
98,108,11,11,0.7272727273,1,0,11,0.8857142857,1,1,1,11,11,11,11,0,0,0,0,2,1,1,35,35,35,35,0,1
365,380,16,16,0.9411764706,1,0,16,0.9841269841,1,1,1,17,17,17,17,0,0,0,0,2,1,1,126,126,126,126,0,1
17,26,9,10,0.7,0.7,1,9.5,0.9583333333,0.9791666667,0.7,0.96875,9,10,9,10,1,2,3,5,2,1,1,95,96,95,96,1,1
12,63,52,52,1,1,0,52,1,1,1,1,45,45,45,45,0,0,0,0,0,0,0,402,402,402,402,0,1
365,379,15,15,0.4,0.8,0,15,0.6607142857,0.7946428571,0.6,0.6428571429,15,15,15,15,0,0,0,0,2,1,1,112,111,111,112,1,0
10,1554,1,1545,0.0384615385,0.0384615385,1544,773,0.9333036905,0.9333036905,0.0384615385,0.9333036905,1,26,1,26,25,0,1,1,0,0,0,2099,2249,2099,2249,150,0
154,163,10,11,0.7692307692,0.7692307692,1,10.5,0.8181818182,0.8282828283,0.2307692308,0.6262626263,13,12,12,13,1,0,0,0,2,1,1,99,82,82,99,17,1
372,402,31,31,1,1,0,31,1,1,1,1,31,31,31,31,0,0,0,0,2,1,1,217,217,217,217,0,0
10,1468,1,1459,0.0357142857,0.0357142857,1458,730,0.9316466933,0.9316466933,0.0357142857,0.9316466933,1,28,1,28,27,0,1,1,0,0,0,2099,2253,2099,2253,154,0
48,719,672,672,1,1,0,672,1,1,1,1,576,576,576,576,0,0,0,0,0,0,0,4906,4906,4906,4906,0,1
41,46,6,6,0.3333333333,1,0,6,0.7692307692,1,0.5,0.8461538462,6,6,6,6,0,0,0,0,2,1,1,26,26,26,26,0,0
52,589,538,538,1,1,0,538,1,1,1,1,485,485,485,485,0,0,0,0,0,0,0,4478,4478,4478,4478,0,1
44,53,10,10,1,1,0,10,1,1,1,1,10,10,10,10,0,0,0,0,2,1,1,82,82,82,82,0,1
24,69,46,46,1,1,0,46,1,1,1,1,40,40,40,40,0,0,0,0,0,0,0,276,276,276,276,0,1
10,105,1,96,0.0384615385,0.0384615385,95,48.5,0.9333036905,0.9333036905,0.0384615385,0.9333036905,1,26,1,26,25,0,1,1,0,0,0,2099,2249,2099,2249,150,0
414,433,20,20,1,1,0,20,1,1,1,1,21,21,21,21,0,0,0,0,2,1,1,189,189,189,189,0,1
34,39,6,6,0.8333333333,1,0,6,0.9791666667,1,1,1,6,6,6,6,0,0,0,0,2,1,1,48,48,48,48,0,1
393,437,45,52,0.5192307692,0.5384615385,7,48.5,0.7887323944,0.8345070423,0.4038461538,0.7676056338,52,45,45,52,7,0,0,0,2,1,1,280,284,280,284,4,1
509,520,12,12,1,1,0,12,1,1,1,1,13,13,13,13,0,0,0,0,2,1,1,123,123,123,123,0,1
18,275,258,258,1,1,0,258,1,1,1,1,225,225,225,225,0,0,0,0,0,0,0,1865,1865,1865,1865,0,1
258,291,34,34,0.9411764706,0.9705882353,0,34,0.984962406,0.9887218045,0.9117647059,0.969924812,34,34,34,34,0,0,0,0,2,1,1,264,266,264,266,2,1
324,331,8,8,0.75,0.875,0,8,0.7692307692,0.8717948718,0.75,0.8205128205,8,8,8,8,0,0,0,0,2,1,1,39,35,35,39,4,1
135,306,172,172,1,1,0,172,1,1,1,1,167,167,167,167,0,1,1,2,4,2,2,1270,1270,1270,1270,0,0
108,116,9,9,0.8888888889,1,0,9,0.9242424242,1,1,1,9,9,9,9,0,1,1,2,2,1,1,66,66,66,66,0,1
506,524,19,19,1,1,0,19,1,1,1,1,20,20,20,20,0,0,0,0,2,1,1,235,235,235,235,0,1
4,205,202,202,1,1,0,202,1,1,1,1,183,183,183,183,0,0,0,0,0,0,0,1536,1536,1536,1536,0,1
983,999,17,17,1,1,0,17,1,1,1,1,17,17,17,17,0,0,0,0,2,1,1,248,248,248,248,0,1
58,70,12,13,0.3846153846,0.7692307692,1,12.5,0.6888888889,0.8666666667,0.5384615385,0.7888888889,12,13,12,13,1,0,0,0,2,1,1,79,90,79,90,11,1
18,275,258,258,1,1,0,258,1,1,1,1,225,225,225,225,0,0,0,0,0,0,0,1865,1865,1865,1865,0,1
10,10,1,1,1,1,0,1,1,1,1,1,1,1,1,1,0,0,0,0,0,0,0,2099,2099,2099,2099,0,0
910,922,13,14,0.4285714286,0.8571428571,1,13.5,0.7482014388,0.8705035971,0.2857142857,0.7050359712,14,13,13,14,1,0,0,0,2,1,1,139,121,121,139,18,0
265,287,23,35,0.1428571429,0.1428571429,12,29,0.2992957746,0.4894366197,0.1428571429,0.3309859155,35,23,23,35,12,0,0,0,2,1,1,284,178,178,284,106,0
133,146,12,14,0.5,0.8571428571,2,13,0.7793103448,0.8137931034,0.5,0.7931034483,12,14,12,14,2,0,0,0,2,1,1,118,145,118,145,27,1
910,922,12,13,0.4615384615,0.8461538462,1,12.5,0.826446281,0.9504132231,0.3076923077,0.7603305785,12,13,12,13,1,0,0,0,2,1,1,119,121,119,121,2,0
30,38,9,9,0.2727272727,0.3636363636,0,9,0.5113636364,0.6931818182,0.1818181818,0.5340909091,10,11,10,11,1,0,0,0,2,1,1,88,87,87,88,1,0
493,507,11,15,0.4375,0.5,4,13,0.8034682081,0.8554913295,0.125,0.6589595376,12,16,12,16,4,0,0,0,2,1,1,159,173,159,173,14,0
70,84,15,15,0.8666666667,0.8666666667,0,15,0.9349593496,0.9674796748,0.2,0.7479674797,15,15,15,15,0,0,0,0,2,1,1,119,123,119,123,4,1
1323,1333,11,11,0.6363636364,1,0,11,0.8260869565,1,1,1,11,11,11,11,0,0,0,0,2,1,1,46,46,46,46,0,1
242,252,11,11,1,1,0,11,1,1,1,1,12,12,12,12,0,2,2,4,2,1,1,98,98,98,98,0,1
6,11,6,6,1,1,0,6,1,1,1,1,7,7,7,7,0,0,0,0,2,1,1,83,83,83,83,0,1
35,1554,1,1520,0,0,1519,760.5,0.2851110203,0.2851110203,0,0.2851110203,1,616,1,616,615,0,1,1,0,0,0,2094,7341,2094,7341,5247,0
10,84,1,75,0.0384615385,0.0384615385,74,38,0.9333036905,0.9333036905,0.0384615385,0.9333036905,1,26,1,26,25,0,1,1,0,0,0,2099,2249,2099,2249,150,0
58,354,297,297,0.930875576,0.9907834101,0,297,0.9831430125,0.9934747145,0.4792626728,0.8162044589,217,217,217,217,0,0,0,0,0,0,0,1839,1827,1827,1839,12,1
4,205,202,202,1,1,0,202,1,1,1,1,183,183,183,183,0,0,0,0,0,0,0,1536,1536,1536,1536,0,1
290,308,19,19,1,1,0,19,1,1,1,1,21,21,21,21,0,1,1,2,2,1,1,169,169,169,169,0,1
342,350,9,9,0.4444444444,0.7777777778,0,9,0.6125,0.725,0.3333333333,0.5,9,9,9,9,0,0,0,0,2,1,1,80,59,59,80,21,1
4,205,202,202,1,1,0,202,1,1,1,1,183,183,183,183,0,0,0,0,0,0,0,1536,1536,1536,1536,0,1
115,127,13,15,0.2666666667,0.2666666667,2,14,0.3775510204,0.6020408163,0.2666666667,0.4489795918,15,13,13,15,2,0,0,0,2,1,1,98,84,84,98,14,0
4,205,202,202,1,1,0,202,1,1,1,1,183,183,183,183,0,0,0,0,0,0,0,1536,1536,1536,1536,0,1
834,844,10,11,0.0909090909,0.5454545455,1,10.5,0.4204545455,0.6931818182,0.0909090909,0.4886363636,10,11,10,11,1,0,0,0,2,1,1,68,88,68,88,20,0
4,205,202,202,1,1,0,202,1,1,1,1,183,183,183,183,0,0,0,0,0,0,0,1536,1536,1536,1536,0,1
1440,1458,15,19,0.4736842105,0.7368421053,4,17,0.7168674699,0.7771084337,0.4736842105,0.7289156627,15,19,15,19,4,0,0,0,2,1,1,129,166,129,166,37,0
967,976,10,10,0.8333333333,0.8333333333,0,10,0.829787234,0.8723404255,0.3333333333,0.6382978723,12,12,12,12,0,0,0,0,2,1,1,94,91,91,94,3,1
339,908,570,571,1,1,1,570.5,1,1,1,1,375,375,375,375,0,0,0,0,2,1,1,2967,2967,2967,2967,0,0
373,383,11,11,1,1,0,11,1,1,1,1,13,13,13,13,0,0,0,0,2,1,1,95,95,95,95,0,1
52,605,554,554,1,1,0,554,1,1,1,1,500,500,500,500,0,0,0,0,0,0,0,4569,4569,4569,4569,0,1
292,306,15,20,0.2,0.2,5,17.5,0.347826087,0.5072463768,0.2,0.3913043478,20,15,15,20,5,0,0,0,2,1,1,138,102,102,138,36,0
533,542,10,12,0.1666666667,0.25,2,11,0.3365384615,0.5769230769,0.1666666667,0.4038461538,12,10,10,12,2,0,0,0,2,1,1,104,78,78,104,26,0
428,448,18,21,0.7391304348,0.7826086957,3,19.5,0.7951807229,0.813253012,0.347826087,0.656626506,20,23,20,23,3,0,0,0,2,1,1,137,166,137,166,29,0
87,96,10,10,0.3,0.5,0,10,0.546875,0.671875,0.4,0.5625,10,10,10,10,0,0,0,0,3,1,2,56,64,56,64,8,0
176,189,10,14,0.1428571429,0.2142857143,4,12,0.3602941176,0.5955882353,0.1428571429,0.4485294118,10,14,10,14,4,0,0,0,2,1,1,96,136,96,136,40,0
126,138,13,13,1,1,0,13,1,1,1,1,13,13,13,13,0,0,0,0,2,1,1,111,111,111,111,0,1
1313,1319,7,7,0.5714285714,0.8571428571,0,7,0.7647058824,0.8431372549,0.5714285714,0.7254901961,7,7,7,7,0,0,0,0,2,1,1,51,43,43,51,8,0
1420,1437,17,18,0.6666666667,0.8333333333,1,17.5,0.88125,0.93125,0.3333333333,0.83125,17,18,17,18,1,0,0,0,2,1,1,149,160,149,160,11,0
351,372,22,22,1,1,0,22,1,1,1,1,22,22,22,22,0,0,0,0,2,1,1,287,287,287,287,0,1
422,457,36,36,1,1,0,36,1,1,1,1,38,38,38,38,0,0,0,0,2,1,1,349,349,349,349,0,1
3,47,45,45,1,1,0,45,1,1,1,1,38,38,38,38,0,0,0,0,0,0,0,245,245,245,245,0,1
650,669,20,20,0.8571428571,1,0,20,0.9806451613,1,1,1,21,21,21,21,0,1,1,2,4,2,2,155,155,155,155,0,1
160,164,5,5,0.6666666667,1,0,5,0.9672131148,1,1,1,6,6,6,6,0,2,2,4,2,1,1,61,61,61,61,0,0
648,665,18,18,1,1,0,18,1,1,1,1,20,20,20,20,0,0,0,0,2,1,1,137,137,137,137,0,1
402,409,4,8,0,0,4,6,0.3146067416,0.5842696629,0,0.404494382,4,9,4,9,5,0,1,1,2,1,1,79,89,79,89,10,0
790,801,12,12,0.5833333333,0.9166666667,0,12,0.9130434783,0.9913043478,0.75,0.9304347826,12,12,12,12,0,0,0,0,2,1,1,114,115,114,115,1,0
68,74,7,7,0.5714285714,0.7142857143,0,7,0.5348837209,0.6511627907,0.5714285714,0.5813953488,7,7,7,7,0,0,0,0,3,2,1,43,28,28,43,15,0
452,468,17,17,1,1,0,17,1,1,1,1,17,17,17,17,0,0,0,0,2,1,1,119,119,119,119,0,1
815,824,10,11,0.5384615385,0.7692307692,1,10.5,0.7171717172,0.797979798,0.3076923077,0.6161616162,13,12,12,13,1,0,0,0,2,1,1,99,90,90,99,9,0
133,146,11,14,0.4285714286,0.7857142857,3,12.5,0.6896551724,0.724137931,0.5,0.7103448276,11,14,11,14,3,0,0,0,2,1,1,105,145,105,145,40,0
831,841,11,13,0.5714285714,0.8571428571,2,12,0.8307692308,0.9076923077,0.8571428571,0.8923076923,7,7,7,7,0,1,1,2,4,2,2,65,59,59,65,6,0
85,103,19,19,0.3157894737,1,0,19,0.9319371728,1,1,1,19,19,19,19,0,0,0,0,2,1,1,191,191,191,191,0,0
15,18,4,5,0,0.5,1,4.5,0.5,0.6428571429,0.25,0.6071428571,4,3,3,4,1,1,1,2,0,0,0,28,18,18,28,10,0
31,55,17,25,0,0.8888888889,8,21,0.7397260274,0.9863013699,0.8888888889,0.9863013699,9,9,9,9,0,0,0,0,0,0,0,72,73,72,73,1,0
854,873,18,20,0.3,0.9,2,19,0.8291457286,0.9296482412,0.7,0.8994974874,18,20,18,20,2,0,0,0,2,1,1,185,199,185,199,14,0
367,396,30,30,0.724137931,0.9655172414,0,30,0.9482071713,0.9920318725,0.7586206897,0.9243027888,29,29,29,29,0,2,2,4,4,2,2,249,251,249,251,2,0
897,917,21,24,0.1666666667,0.25,3,22.5,0.3450292398,0.5087719298,0.1666666667,0.3625730994,24,21,21,24,3,0,0,0,2,1,1,143,171,143,171,28,0
548,549,2,2,0,0,0,2,0.7671232877,0.7671232877,0,0.6301369863,2,2,2,2,0,0,1,1,2,1,1,69,73,69,73,4,0
301,342,42,42,0.5,1,0,42,0.923364486,1,0.4130434783,0.9177570093,46,46,46,46,0,0,0,0,2,1,1,535,535,535,535,0,1
940,952,13,17,0.4117647059,0.7058823529,4,15,0.6136363636,0.6875,0.2941176471,0.5795454545,17,13,13,17,4,0,0,0,2,1,1,176,121,121,176,55,0
589,601,13,13,0.5384615385,0.9230769231,0,13,0.8595041322,0.9338842975,0.3846153846,0.7685950413,13,13,13,13,0,0,0,0,2,1,1,114,121,114,121,7,0
46,50,5,5,0.2,0.8,0,5,0.8852459016,0.9672131148,0.8,0.9672131148,5,5,5,5,0,1,0,1,2,1,1,59,61,59,61,2,0
110,156,47,47,0,0,0,47,0.0104166667,0.5,0,0.296875,24,24,24,24,0,0,0,0,0,0,0,192,192,192,192,0,0
126,133,8,8,0.5,0.75,0,8,0.9154929577,0.9436619718,0.75,0.9436619718,8,8,8,8,0,0,0,0,2,1,1,67,71,67,71,4,0
1021,1027,7,7,0.5714285714,0.8571428571,0,7,0.6666666667,0.8095238095,0.8571428571,0.8095238095,7,7,7,7,0,0,0,0,2,1,1,36,42,36,42,6,0
371,379,9,9,0.5555555556,1,0,9,0.8823529412,1,1,1,9,9,9,9,0,0,0,0,2,1,1,51,51,51,51,0,0
60,75,16,19,0.2727272727,0.3636363636,3,17.5,0.3692307692,0.5538461538,0.2727272727,0.4461538462,11,11,11,11,0,1,0,1,4,2,2,54,65,54,65,11,0
572,592,18,21,0.7391304348,0.7826086957,3,19.5,0.7951807229,0.813253012,0.347826087,0.656626506,20,23,20,23,3,0,0,0,2,1,1,137,166,137,166,29,1
33,55,23,23,0.3043478261,0.9565217391,0,23,0.7983870968,0.9758064516,0.9565217391,0.9758064516,23,23,23,23,0,0,1,1,2,1,1,124,122,122,124,2,0
414,433,20,20,1,1,0,20,1,1,1,1,21,21,21,21,0,0,0,0,2,1,1,189,189,189,189,0,1
412,419,8,17,0.125,0.125,9,12.5,0.3243243243,0.5675675676,0.125,0.4459459459,7,8,7,8,1,1,1,2,3,2,1,74,74,74,74,0,0
286,293,8,8,0.5,0.75,0,8,0.6315789474,0.7368421053,0.5,0.6052631579,8,8,8,8,0,0,0,0,2,1,1,38,33,33,38,5,0
1085,1092,3,8,0,0,5,5.5,0.34,0.56,0,0.44,3,8,3,8,5,1,0,1,2,1,1,47,50,47,50,3,0
62,64,3,3,0,1,0,3,0.8269230769,1,1,1,3,3,3,3,0,0,0,0,2,1,1,52,52,52,52,0,0
863,876,14,14,0.2727272727,1,0,14,0.6734693878,1,0.6363636364,0.8571428571,11,11,11,11,0,1,1,2,4,2,2,49,49,49,49,0,0
115,121,6,7,0,0,1,6.5,0.3606557377,0.606557377,0,0.4754098361,7,7,7,7,0,2,0,2,2,1,1,61,60,60,61,1,0
910,940,31,31,0.6896551724,1,0,31,0.9645669291,1,1,1,29,29,29,29,0,1,1,2,4,2,2,254,254,254,254,0,0
17,26,9,10,0.7,0.7,1,9.5,0.8409090909,0.8636363636,0.3,0.7045454545,9,10,9,10,1,0,0,0,2,1,1,39,44,39,44,5,0
76,92,10,17,0.1666666667,0.1666666667,7,13.5,0.28,0.52,0.1666666667,0.3466666667,10,12,10,12,2,0,0,0,3,1,2,57,75,57,75,18,0
454,470,12,17,0.5294117647,0.7058823529,5,14.5,0.6477272727,0.6704545455,0.2352941176,0.5625,12,17,12,17,5,0,0,0,2,1,1,118,176,118,176,58,1
667,683,17,17,0.4705882353,0.9411764706,0,17,0.8623853211,0.9449541284,0.9411764706,0.9449541284,17,17,17,17,0,1,1,2,2,1,1,103,109,103,109,6,0
160,182,23,23,0.8695652174,0.9565217391,0,23,0.9324324324,0.9662162162,0.4782608696,0.722972973,23,23,23,23,0,3,3,6,2,1,1,146,148,146,148,2,0
215,221,7,7,0.2857142857,1,0,7,0.8382352941,1,1,1,7,7,7,7,0,1,1,2,2,1,1,68,68,68,68,0,0
271,276,6,6,0.8333333333,0.8333333333,0,6,0.8260869565,0.8550724638,0.8333333333,0.8550724638,6,6,6,6,0,0,0,0,2,1,1,69,59,59,69,10,0
731,742,12,12,0,1,0,12,0.7777777778,1,1,1,12,12,12,12,0,0,0,0,2,1,1,108,108,108,108,0,0
298,377,80,80,1,1,0,80,1,1,1,1,80,80,80,80,0,0,0,0,2,1,1,560,560,560,560,0,1
62,89,28,28,0,0,0,28,0.4444444444,0.7777777778,0,0.7777777778,28,28,28,28,0,0,0,0,2,1,1,196,252,196,252,56,0
199,206,8,8,0.5,0.75,0,8,0.9014084507,0.9436619718,0.75,0.9436619718,8,8,8,8,0,0,0,0,2,1,1,67,71,67,71,4,0
34,36,3,3,0,0.6666666667,0,3,0.7678571429,0.9285714286,0.6666666667,0.9285714286,3,3,3,3,0,0,0,0,2,1,1,52,56,52,56,4,0
73,82,8,10,0.6,0.7,2,9,0.9032258065,0.9193548387,0.7,0.9193548387,9,10,9,10,1,0,0,0,2,1,1,62,62,62,62,0,0
81,88,8,8,0.875,0.875,0,8,0.9342105263,0.9605263158,0.875,0.9473684211,8,8,8,8,0,3,3,6,2,1,1,76,73,73,76,3,0
396,402,7,8,0.375,0.75,1,7.5,0.5405405405,0.7297297297,0.375,0.5675675676,8,7,7,8,1,0,0,0,3,1,2,37,28,28,37,9,0
248,260,12,13,0.3846153846,0.6153846154,1,12.5,0.8443113772,0.9161676647,0.6153846154,0.880239521,12,13,12,13,1,0,0,0,2,1,1,167,160,160,167,7,1
208,214,7,7,0.4285714286,0.7142857143,0,7,0.7313432836,0.8507462687,0.7142857143,0.8507462687,7,7,7,7,0,0,0,0,2,1,1,67,57,57,67,10,0
101,109,9,9,0.8888888889,1,0,9,0.9924242424,1,1,1,9,9,9,9,0,0,0,0,2,1,1,132,132,132,132,0,1
304,312,9,9,0.4444444444,1,0,9,0.8305084746,1,1,1,9,9,9,9,0,1,1,2,2,1,1,59,59,59,59,0,0
46,51,6,6,0.5,0.8333333333,0,6,0.8076923077,0.9230769231,0.5,0.8461538462,6,6,6,6,0,0,0,0,2,1,1,26,26,26,26,0,0
417,429,13,13,1,1,0,13,1,1,1,1,13,13,13,13,0,2,2,4,2,1,1,115,115,115,115,0,0
340,350,10,11,0.1818181818,0.1818181818,1,10.5,0.3194444444,0.5277777778,0.1818181818,0.4166666667,9,11,9,11,2,0,3,3,3,2,1,66,72,66,72,6,0
395,401,5,7,0.4545454545,0.6363636364,2,6,0.7333333333,0.78,0,0.64,8,11,8,11,3,0,0,0,2,1,1,120,150,120,150,30,0
76,88,13,13,0,1,0,13,0.5714285714,1,1,1,13,13,13,13,0,0,0,0,2,1,1,91,91,91,91,0,0
620,630,10,11,0.6923076923,0.7692307692,1,10.5,0.7878787879,0.8282828283,0.2307692308,0.6262626263,12,13,12,13,1,0,0,0,2,1,1,82,99,82,99,17,0
74,79,6,7,0.2857142857,0.4285714286,1,6.5,0.75,0.7738095238,0.2857142857,0.7261904762,7,6,6,7,1,0,0,0,2,1,1,84,72,72,84,12,0
68,77,9,10,0.3,0.7,1,9.5,0.3703703704,0.5432098765,0.3,0.4074074074,9,10,9,10,1,0,0,0,2,1,1,45,81,45,81,36,0
662,667,6,6,0.8333333333,1,0,6,0.9824561404,1,1,1,6,6,6,6,0,1,1,2,2,1,1,57,57,57,57,0,0
669,679,11,11,0,0.9090909091,0,11,0.6666666667,0.8452380952,0,0.619047619,11,11,11,11,0,0,0,0,2,1,1,84,72,72,84,12,0
100,138,39,39,1,1,0,39,1,1,1,1,19,19,19,19,0,1,1,2,4,2,2,121,121,121,121,0,1
459,471,12,13,0.6923076923,0.7692307692,1,12.5,0.8787878788,0.9166666667,0.5384615385,0.7954545455,12,13,12,13,1,1,1,2,2,1,1,132,127,127,132,5,0
156,158,3,7,0,0,4,5,0.2631578947,0.5,0,0.3289473684,7,3,3,7,4,0,0,0,2,1,1,76,61,61,76,15,0
68,70,3,3,0,0.6666666667,0,3,0.75,0.9285714286,0.6666666667,0.9285714286,3,3,3,3,0,0,0,0,2,1,1,56,52,52,56,4,0
192,206,14,15,0.8,0.8666666667,1,14.5,0.8404255319,0.8617021277,0.6,0.7978723404,14,15,14,15,1,0,0,0,2,1,1,86,94,86,94,8,1
497,507,10,11,0.5384615385,0.7692307692,1,10.5,0.7171717172,0.797979798,0.3076923077,0.6161616162,12,13,12,13,1,0,0,0,2,1,1,90,99,90,99,9,1
113,133,21,21,1,1,0,21,1,1,1,1,22,22,22,22,0,0,0,0,2,1,1,162,162,162,162,0,1
246,251,6,6,0.7142857143,0.8571428571,0,6,0.8405797101,0.884057971,0.2857142857,0.6231884058,7,7,7,7,0,1,1,2,2,1,1,61,69,61,69,8,0
150,156,7,7,0.2857142857,0.5714285714,0,7,0.7045454545,0.8409090909,0.4285714286,0.7954545455,7,7,7,7,0,0,0,0,2,1,1,42,44,42,44,2,0
71,79,9,9,0,1,0,9,0.8085106383,1,1,1,9,9,9,9,0,0,0,0,2,1,1,47,47,47,47,0,0
147,157,11,11,0.8181818182,1,0,11,0.9661016949,1,1,1,11,11,11,11,0,1,1,2,2,1,1,59,59,59,59,0,0
356,364,9,9,0.4444444444,0.7777777778,0,9,0.5777777778,0.6888888889,0.4444444444,0.5555555556,9,9,9,9,0,0,0,0,2,1,1,35,45,35,45,10,0
836,852,16,17,0.3529411765,0.9411764706,1,16.5,0.8370786517,0.9606741573,0.7058823529,0.9269662921,16,17,16,17,1,0,0,0,2,1,1,171,178,171,178,7,0
119,128,10,10,0.9090909091,0.9090909091,0,10,0.9213483146,0.9213483146,0.9090909091,0.9213483146,11,11,11,11,0,0,0,0,2,1,1,89,82,82,89,7,1
917,930,14,14,0.8571428571,0.9285714286,0,14,0.9166666667,0.9444444444,0.3571428571,0.7847222222,14,14,14,14,0,0,0,0,2,1,1,136,144,136,144,8,1
197,207,11,11,0.9090909091,0.9090909091,0,11,0.9761904762,0.9761904762,0.9090909091,0.9761904762,11,11,11,11,0,0,0,0,2,1,1,123,126,123,126,3,1
378,437,60,60,0,0,0,60,0.4444444444,0.7777777778,0,0.7777777778,60,60,60,60,0,0,0,0,2,1,1,420,540,420,540,120,0
523,531,9,9,0.6363636364,0.7272727273,0,9,0.7066666667,0.7733333333,0.3636363636,0.64,11,11,11,11,0,0,0,0,2,1,1,74,75,74,75,1,0
4,201,198,198,1,1,0,198,1,1,1,1,181,181,181,181,0,3,3,6,2,1,1,1533,1533,1533,1533,0,1
43,52,10,10,1,1,0,10,1,1,1,1,10,10,10,10,0,0,0,0,2,1,1,88,88,88,88,0,1
200,214,15,15,1,1,0,15,1,1,1,1,15,15,15,15,0,0,0,0,2,1,1,198,198,198,198,0,1
292,307,15,16,0.25,0.75,1,15.5,0.6086956522,0.7826086957,0.4375,0.6666666667,15,16,15,16,1,0,0,0,2,1,1,63,69,63,69,6,0
71,81,11,13,0.75,0.75,2,12,0.9736842105,0.9736842105,0.75,0.9736842105,12,11,11,12,1,0,0,0,2,1,1,76,75,75,76,1,1
448,457,10,10,0.8,0.8,0,10,0.86,0.86,0.4,0.66,10,10,10,10,0,0,0,0,2,1,1,44,50,44,50,6,1
164,197,34,34,1,1,0,34,1,1,1,1,34,34,34,34,0,1,1,2,4,2,2,243,243,243,243,0,1
1156,1170,15,16,0.5625,0.875,1,15.5,0.8676470588,0.9264705882,0.3125,0.8014705882,16,15,15,16,1,0,0,0,2,1,1,136,126,126,136,10,1
1277,1311,35,35,0.4285714286,1,0,35,0.8897959184,1,1,1,35,35,35,35,0,0,0,0,2,1,1,245,245,245,245,0,0
297,304,8,8,0.75,0.875,0,8,0.9763779528,0.9842519685,0.875,0.9842519685,8,8,8,8,0,0,0,0,2,1,1,127,125,125,127,2,1
1234,1262,29,29,0.3181818182,0.9545454545,0,29,0.75,0.9895833333,0.9545454545,0.9895833333,22,22,22,22,0,1,1,2,4,2,2,96,96,96,96,0,0
68,74,6,7,0.1428571429,0.7142857143,1,6.5,0.6285714286,0.8857142857,0.2857142857,0.6857142857,6,7,6,7,1,0,0,0,2,1,1,32,35,32,35,3,0
45,50,6,6,0.6666666667,0.8333333333,0,6,0.8888888889,0.962962963,0.8333333333,0.962962963,6,6,6,6,0,0,0,0,2,1,1,26,27,26,27,1,0
28,38,11,11,0,0,0,11,0.3793103448,0.7931034483,0,0.5517241379,6,6,6,6,0,0,0,0,0,0,0,29,24,24,29,5,0
61,63,3,3,0,1,0,3,0.8571428571,1,0.6666666667,0.9642857143,3,3,3,3,0,0,0,0,2,1,1,56,56,56,56,0,0
473,490,18,20,0.45,0.85,2,19,0.7752293578,0.8394495413,0.2,0.6834862385,20,18,18,20,2,0,0,0,2,1,1,218,183,183,218,35,0
493,501,8,9,0.7272727273,0.7272727273,1,8.5,0.76,0.8,0.2727272727,0.6,10,11,10,11,1,0,0,0,2,1,1,62,75,62,75,13,0
314,336,23,23,0.9565217391,0.9565217391,0,23,0.9788135593,0.9788135593,0.9565217391,0.9788135593,23,23,23,23,0,0,0,0,2,1,1,231,236,231,236,5,1
141,146,6,6,0.3333333333,0.5,0,6,0.7179487179,0.7692307692,0.3333333333,0.7051282051,6,6,6,6,0,0,0,0,2,1,1,78,64,64,78,14,0
81,86,6,7,0,0.1428571429,1,6.5,0.3650793651,0.619047619,0,0.4603174603,7,6,6,7,1,1,1,2,2,1,1,63,59,59,63,4,0
566,571,6,7,0.2857142857,0.7142857143,1,6.5,0.5,0.7142857143,0.7142857143,0.6904761905,7,6,6,7,1,0,0,0,2,1,1,42,32,32,42,10,0
80,104,25,25,0.75,1,0,25,0.9709543568,1,1,1,28,28,28,28,0,1,1,2,2,1,1,241,241,241,241,0,1
85,98,14,18,0.6111111111,0.7222222222,4,16,0.6470588235,0.6691176471,0.5,0.6323529412,18,14,14,18,4,0,0,0,2,1,1,136,91,91,136,45,1
290,339,41,50,0.3,0.95,9,45.5,0.6956521739,0.9855072464,0.95,0.9855072464,20,20,20,20,0,1,1,2,4,2,2,69,69,69,69,0,0
317,335,19,19,0.7777777778,1,0,19,0.958677686,1,1,1,18,18,18,18,0,1,1,2,4,2,2,121,121,121,121,0,1
62,78,17,17,0.6315789474,0.9473684211,0,17,0.903030303,0.9515151515,0.9473684211,0.9454545455,19,19,19,19,0,1,0,1,2,1,1,165,159,159,165,6,1
28,46,19,28,0,0,9,23.5,0.393442623,0.6885245902,0,0.5245901639,9,10,9,10,1,2,2,4,1,0,1,60,61,60,61,1,0
66,73,8,8,0.5,0.875,0,8,0.4545454545,0.5818181818,0.5,0.5272727273,8,8,8,8,0,0,0,0,3,2,1,55,34,34,55,21,0
871,883,13,13,0.6111111111,1,0,13,0.9363636364,1,1,1,18,18,18,18,0,1,1,2,4,2,2,110,110,110,110,0,0
134,142,9,9,0.5555555556,1,0,9,0.9393939394,1,1,1,9,9,9,9,0,1,1,2,2,1,1,66,66,66,66,0,0
104,109,4,6,0,0,2,5,0.3636363636,0.5584415584,0,0.3896103896,4,7,4,7,3,0,2,2,2,1,1,55,77,55,77,22,0
727,733,7,7,0.6666666667,0.8888888889,0,7,0.8378378378,0.8783783784,0.2222222222,0.6216216216,9,9,9,9,0,0,0,0,2,1,1,74,66,66,74,8,0
588,598,11,11,0.5454545455,0.9090909091,0,11,0.746031746,0.9206349206,0.9090909091,0.9206349206,11,11,11,11,0,0,1,1,2,1,1,63,60,60,63,3,0
181,186,6,6,0.5,1,0,6,0.9444444444,1,1,1,6,6,6,6,0,0,0,0,2,1,1,54,54,54,54,0,1
27,46,20,20,1,1,0,20,1,1,1,1,20,20,20,20,0,0,0,0,2,1,1,261,261,261,261,0,1
779,787,9,10,0.7,0.8,1,9.5,0.8118811881,0.8316831683,0.1,0.5742574257,10,9,9,10,1,1,1,2,2,1,1,101,85,85,101,16,1
313,322,10,11,0.2727272727,0.8181818182,1,10.5,0.7540983607,0.9016393443,0.8181818182,0.9016393443,11,10,10,11,1,1,0,1,2,1,1,57,61,57,61,4,0
261,267,7,7,0.4285714286,0.8571428571,0,7,0.625,0.8125,0.5714285714,0.71875,7,7,7,7,0,0,0,0,2,1,1,27,32,27,32,5,0
559,571,13,14,0.6428571429,0.9285714286,1,13.5,0.8699186992,0.9430894309,0.3571428571,0.7642276423,14,13,13,14,1,0,0,0,2,1,1,123,116,116,123,7,1
339,348,10,10,0.9090909091,0.9090909091,0,10,0.9528301887,0.9528301887,0.0909090909,0.6226415094,10,11,10,11,1,1,1,2,2,1,1,101,106,101,106,5,1
74,77,4,4,0,0.75,0,4,0.8235294118,0.9411764706,0.75,0.9264705882,4,4,4,4,0,0,0,0,2,1,1,64,68,64,68,4,0
446,451,6,6,0.6666666667,0.8333333333,0,6,0.7746478873,0.8028169014,0.5,0.7464788732,6,6,6,6,0,1,1,2,2,1,1,57,71,57,71,14,1
42,125,84,84,0,0,0,84,0.25,0.4375,0,0.4375,84,84,84,84,0,0,0,0,1,1,0,588,1344,588,1344,756,0
114,125,11,12,0,0,1,11.5,0.3913043478,0.6304347826,0,0.4456521739,11,12,11,12,1,4,1,5,2,1,1,92,88,88,92,4,0
526,534,9,9,1,1,0,9,1,1,1,1,10,10,10,10,0,0,0,0,2,1,1,109,109,109,109,0,1
370,447,73,78,0.9294117647,0.9411764706,5,75.5,0.9532846715,0.9547445255,0.2588235294,0.7562043796,80,85,80,85,5,0,0,0,2,1,1,654,685,654,685,31,1
524,546,18,23,0.68,0.72,5,20.5,0.7165775401,0.7326203209,0.32,0.5989304813,20,25,20,25,5,0,0,0,2,1,1,137,187,137,187,50,1
419,444,26,26,1,1,0,26,1,1,1,1,26,26,26,26,0,0,0,0,2,1,1,182,182,182,182,0,1
582,602,21,21,0.3,0.95,0,21,0.7487437186,0.9698492462,0.7,0.9095477387,20,20,20,20,0,0,0,0,4,2,2,199,193,193,199,6,1
223,231,9,9,0.3333333333,1,0,9,0.8666666667,1,1,1,9,9,9,9,0,1,1,2,2,1,1,45,45,45,45,0,1
726,734,8,9,0.7272727273,0.8181818182,1,8.5,0.76,0.8266666667,0.6363636364,0.7866666667,10,11,10,11,1,0,0,0,2,1,1,65,75,65,75,10,0
90,90,1,1,0,0,0,1,0.4911937378,0.675146771,0,0.675146771,1,1,1,1,0,0,0,0,2,1,1,345,511,345,511,166,1
1101,1108,8,8,0.375,0.75,0,8,0.5882352941,0.8039215686,0.5,0.6470588235,8,8,8,8,0,0,0,0,2,1,1,45,51,45,51,6,0
92,100,6,9,0.125,0.125,3,7.5,0.3292682927,0.5609756098,0.125,0.4268292683,6,8,6,8,2,0,0,0,3,1,2,82,72,72,82,10,0
542,574,33,33,0,1,0,33,0.5714285714,1,1,1,33,33,33,33,0,0,0,0,2,1,1,231,231,231,231,0,0
1747,1760,14,14,1,1,0,14,1,1,1,1,15,15,15,15,0,0,0,0,2,1,1,120,120,120,120,0,1
790,801,12,13,0.5384615385,0.8461538462,1,12.5,0.8925619835,0.9421487603,0.3076923077,0.7768595041,13,12,12,13,1,0,0,0,2,1,1,121,115,115,121,6,1
74,78,5,5,0.6666666667,1,0,5,0.9672131148,1,1,1,6,6,6,6,0,2,2,4,2,1,1,61,61,61,61,0,1
95,139,41,45,0.6176470588,0.6176470588,4,43,0.8193430657,0.901459854,0.2941176471,0.6861313869,31,34,31,34,3,1,1,2,4,2,2,494,548,494,548,54,1
73,82,8,10,0.6,0.7,2,9,0.9032258065,0.9193548387,0.7,0.9193548387,9,10,9,10,1,0,0,0,2,1,1,62,62,62,62,0,1
116,130,14,15,0.4,0.8666666667,1,14.5,0.8616352201,0.9182389937,0.6,0.8742138365,14,15,14,15,1,0,0,0,2,1,1,147,159,147,159,12,1
205,221,15,17,0.8235294118,0.8235294118,2,16,0.9782608696,0.9782608696,0.8235294118,0.9782608696,15,17,15,17,2,0,0,0,2,1,1,90,92,90,92,2,1
64,71,8,10,0.6,0.7,2,9,0.9032258065,0.9193548387,0.7,0.9193548387,10,9,9,10,1,0,0,0,2,1,1,62,62,62,62,0,1
27,37,10,11,0.7272727273,0.9090909091,1,10.5,0.8823529412,0.9117647059,0.9090909091,0.9117647059,10,11,10,11,1,0,0,0,2,1,1,62,68,62,68,6,1
269,274,6,6,0.6666666667,1,0,6,0.9649122807,1,1,1,6,6,6,6,0,1,1,2,2,1,1,57,57,57,57,0,1
681,688,8,8,0.625,1,0,8,0.9454545455,1,1,1,8,8,8,8,0,0,0,0,2,1,1,55,55,55,55,0,1
1549,1565,14,17,0.5294117647,0.7647058824,3,15.5,0.8028169014,0.8521126761,0.2941176471,0.7323943662,14,17,14,17,3,0,0,0,2,1,1,122,142,122,142,20,1
150,157,8,8,0.125,0.875,0,8,0.765625,0.90625,0.875,0.890625,8,8,8,8,0,0,0,0,2,1,1,59,64,59,64,5,1
28,37,10,10,0.3,1,0,10,0.9326923077,1,1,1,10,10,10,10,0,0,0,0,2,1,1,104,104,104,104,0,1
445,489,45,45,0.3953488372,0.976744186,0,45,0.9256198347,0.9938016529,0.976744186,0.9917355372,43,43,43,43,0,1,1,2,4,2,2,484,482,482,484,2,1
221,252,32,33,0.8235294118,0.8235294118,1,32.5,0.8812260536,0.8927203065,0.3529411765,0.724137931,34,33,33,34,1,0,0,0,2,1,1,261,246,246,261,15,1
96,100,5,5,0.6666666667,1,0,5,0.9672131148,1,1,1,6,6,6,6,0,2,2,4,2,1,1,61,61,61,61,0,1
143,146,4,4,0.5,1,0,4,0.9666666667,1,1,1,4,4,4,4,0,1,1,2,2,1,1,60,60,60,60,0,1
461,474,14,14,1,1,0,14,1,1,1,1,14,14,14,14,0,0,0,0,2,1,1,128,128,128,128,0,1
1589,1596,8,8,0.875,1,0,8,0.9901960784,1,1,1,8,8,8,8,0,0,0,0,2,1,1,102,102,102,102,0,1
119,125,7,7,0.625,0.875,0,7,0.8421052632,0.8947368421,0.375,0.6578947368,8,8,8,8,0,1,1,2,2,1,1,76,68,68,76,8,1
212,228,17,17,1,1,0,17,1,1,1,1,19,19,19,19,0,0,0,0,2,1,1,185,185,185,185,0,1
127,131,5,5,1,1,0,5,1,1,1,1,5,5,5,5,0,0,0,0,2,1,1,80,80,80,80,0,1
546,568,23,23,0.88,1,0,23,0.9786096257,1,1,1,25,25,25,25,0,0,0,0,2,1,1,187,187,187,187,0,1
621,631,11,11,0.8461538462,0.9230769231,0,11,0.9797979798,0.9898989899,0.9230769231,0.9898989899,13,13,13,13,0,0,0,0,2,1,1,99,99,99,99,0,1
1,63,63,63,1,1,0,63,1,1,1,1,57,57,57,57,0,0,0,0,0,0,0,545,545,545,545,0,1
930,937,8,8,1,1,0,8,1,1,1,1,8,8,8,8,0,1,1,2,2,1,1,76,76,76,76,0,1
1006,1019,14,18,0.4444444444,0.7777777778,4,16,0.7702702703,0.8108108108,0.5,0.7297297297,18,14,14,18,4,0,0,0,2,1,1,148,120,120,148,28,1
589,601,13,14,0.5,0.8571428571,1,13.5,0.8292682927,0.9512195122,0.3571428571,0.7642276423,14,13,13,14,1,0,0,0,2,1,1,123,121,121,123,2,1
72,76,5,5,0.6666666667,1,0,5,0.9677419355,1,1,1,6,6,6,6,0,2,2,4,2,1,1,62,62,62,62,0,1
659,675,17,17,0.8235294118,0.8823529412,0,17,0.9029126214,0.9417475728,0.7058823529,0.8834951456,17,17,17,17,0,0,0,0,2,1,1,100,103,100,103,3,1
617,622,6,6,1,1,0,6,1,1,1,1,6,6,6,6,0,0,0,0,2,1,1,25,25,25,25,0,1
1098,1112,15,17,0.4705882353,0.7647058824,2,16,0.8389261745,0.9060402685,0.3529411765,0.8255033557,17,15,15,17,2,0,0,0,2,1,1,149,139,139,149,10,1
110,197,79,88,0.875,0.8863636364,9,83.5,0.9318181818,0.9338842975,0.7159090909,0.8595041322,79,88,79,88,9,0,0,0,2,1,1,452,484,452,484,32,1
546,568,18,23,0.68,0.72,5,20.5,0.7165775401,0.7326203209,0.32,0.5989304813,20,25,20,25,5,0,0,0,2,1,1,137,187,137,187,50,1
488,494,7,7,1,1,0,7,1,1,1,1,7,7,7,7,0,0,0,0,2,1,1,51,51,51,51,0,1
556,566,11,11,0.6923076923,0.8461538462,0,11,0.9117647059,0.9509803922,0.6153846154,0.7843137255,13,13,13,13,0,0,0,0,2,1,1,102,99,99,102,3,1
343,351,9,9,1,1,0,9,1,1,1,1,9,9,9,9,0,0,0,0,2,1,1,49,49,49,49,0,1
60,71,12,12,0.5833333333,0.8333333333,0,12,0.8046875,0.890625,0.5,0.796875,12,12,12,12,0,0,0,0,2,1,1,128,119,119,128,9,1
335,349,15,15,1,1,0,15,1,1,1,1,15,15,15,15,0,0,0,0,2,1,1,117,117,117,117,0,1
106,117,10,12,0.1666666667,0.3333333333,2,11,0.3859649123,0.5789473684,0.1666666667,0.4561403509,10,12,10,12,2,0,0,0,2,1,1,51,57,51,57,6,1
349,374,26,26,0,0,0,26,0.4444444444,0.6666666667,0,0.6666666667,26,26,26,26,0,0,0,0,2,1,1,234,182,182,234,52,1
414,433,20,20,1,1,0,20,1,1,1,1,21,21,21,21,0,0,0,0,2,1,1,189,189,189,189,0,1
378,386,9,9,0.7,1,0,9,0.9605263158,1,1,1,10,10,10,10,0,4,4,8,2,1,1,76,76,76,76,0,1
10,20,11,11,1,1,0,11,1,1,1,1,13,13,13,13,0,1,1,2,2,1,1,122,122,122,122,0,1
924,937,12,14,0.5714285714,0.8571428571,2,13,0.7967479675,0.8699186992,0.3571428571,0.7154471545,12,14,12,14,2,0,0,0,2,1,1,107,123,107,123,16,1
56,63,8,8,0.5,0.75,0,8,0.9014084507,0.9436619718,0.75,0.9436619718,8,8,8,8,0,0,0,0,2,1,1,71,67,67,71,4,1
511,522,12,12,1,1,0,12,1,1,1,1,13,13,13,13,0,0,0,0,2,1,1,123,123,123,123,0,1
678,685,8,8,1,1,0,8,1,1,1,1,9,9,9,9,0,1,1,2,2,1,1,52,52,52,52,0,1
570,590,18,21,0.7391304348,0.7826086957,3,19.5,0.7951807229,0.813253012,0.347826087,0.656626506,20,23,20,23,3,0,0,0,2,1,1,137,166,137,166,29,1
54,62,9,10,0.6,0.7,1,9.5,0.8548387097,0.8709677419,0.7,0.8709677419,10,9,9,10,1,0,0,0,2,1,1,62,62,62,62,0,1
546,554,9,9,1,1,0,9,1,1,1,1,10,10,10,10,0,0,0,0,2,1,1,109,109,109,109,0,1
521,529,9,9,0.6363636364,0.7272727273,0,9,0.6666666667,0.7466666667,0.4545454545,0.56,11,11,11,11,0,0,0,0,2,1,1,64,75,64,75,11,1
26,34,9,9,0.2727272727,0.9090909091,0,9,0.9013157895,0.9802631579,0.9090909091,0.9605263158,11,11,11,11,0,0,0,0,2,1,1,150,152,150,152,2,1
940,952,13,13,0.6153846154,1,0,13,0.958677686,1,1,1,13,13,13,13,0,0,0,0,2,1,1,121,121,121,121,0,1
174,179,6,6,0.8571428571,1,0,6,0.9836065574,1,1,1,7,7,7,7,0,1,1,2,2,1,1,61,61,61,61,0,1
243,252,10,10,1,1,0,10,1,1,1,1,10,10,10,10,0,0,0,0,2,1,1,90,90,90,90,0,1
551,574,24,24,1,1,0,24,1,1,1,1,24,24,24,24,0,0,0,0,2,1,1,168,168,168,168,0,1
317,340,24,25,0.8846153846,0.9230769231,1,24.5,0.904040404,0.9141414141,0.1923076923,0.7070707071,26,25,25,26,1,0,0,0,2,1,1,198,181,181,198,17,1
481,506,26,26,1,1,0,26,1,1,1,1,26,26,26,26,0,0,0,0,2,1,1,182,182,182,182,0,1
546,570,25,25,0.8461538462,1,0,25,0.9759615385,1,1,1,26,26,26,26,0,1,1,2,4,2,2,208,208,208,208,0,1
297,306,10,10,1,1,0,10,1,1,1,1,10,10,10,10,0,0,0,0,2,1,1,77,77,77,77,0,1
200,209,10,10,1,1,0,10,1,1,1,1,10,10,10,10,0,1,1,2,2,1,1,157,157,157,157,0,1
1083,1095,13,17,0.5294117647,0.7647058824,4,15,0.7058823529,0.7385620915,0.2941176471,0.6405228758,17,13,13,17,4,0,0,0,2,1,1,153,113,113,153,40,1
10,34,25,25,0.9565217391,1,0,25,0.9931972789,1,1,1,23,23,23,23,0,3,3,6,2,1,1,147,147,147,147,0,1
1575,1594,13,20,0.4615384615,0.9230769231,7,16.5,0.86,0.93,0.9230769231,0.93,13,13,13,13,0,1,1,2,4,2,2,94,100,94,100,6,1
50,52,3,3,0,1,0,3,0.85,1,1,1,3,3,3,3,0,0,0,0,2,1,1,60,60,60,60,0,1
2,81,80,80,1,1,0,80,1,1,1,1,46,46,46,46,0,1,1,2,2,1,1,259,259,259,259,0,1
579,591,13,13,0.6923076923,1,0,13,0.9393939394,1,1,1,13,13,13,13,0,0,0,0,2,1,1,66,66,66,66,0,1
197,207,11,11,0.8181818182,0.9090909091,0,11,0.9545454545,0.9602272727,0.9090909091,0.9602272727,11,11,11,11,0,1,1,2,2,1,1,176,169,169,176,7,1
84,91,8,8,1,1,0,8,1,1,1,1,8,8,8,8,0,0,0,0,2,1,1,67,67,67,67,0,1
293,308,16,18,0.3333333333,0.8888888889,2,17,0.8216216216,0.9243243243,0.6666666667,0.8918918919,18,16,16,18,2,0,0,0,2,1,1,185,171,171,185,14,1
733,749,17,17,1,1,0,17,1,1,1,1,17,17,17,17,0,0,0,0,2,1,1,100,100,100,100,0,1
13,18,6,6,1,1,0,6,1,1,1,1,6,6,6,6,0,0,0,0,2,1,1,39,39,39,39,0,1
669,683,13,15,0.4666666667,0.8,2,14,0.7046979866,0.7785234899,0.3333333333,0.6510067114,13,15,13,15,2,0,0,0,2,1,1,116,149,116,149,33,1
343,349,7,7,1,1,0,7,1,1,1,1,8,8,8,8,0,1,1,2,2,1,1,88,88,88,88,0,1
361,377,16,17,0.3529411765,0.9411764706,1,16.5,0.8426966292,0.9606741573,0.7058823529,0.9269662921,16,17,16,17,1,0,0,0,2,1,1,171,178,171,178,7,1
592,602,11,11,1,1,0,11,1,1,1,1,12,12,12,12,0,0,0,0,2,1,1,76,76,76,76,0,1
169,177,9,9,1,1,0,9,1,1,1,1,11,11,11,11,0,0,0,0,2,1,1,72,72,72,72,0,1
639,646,8,8,0.8888888889,1,0,8,0.9807692308,1,1,1,9,9,9,9,0,1,1,2,2,1,1,52,52,52,52,0,1
590,600,11,11,0.8181818182,1,0,11,0.984375,1,1,1,11,11,11,11,0,1,1,2,2,1,1,128,128,128,128,0,1
1172,1177,6,6,0.5,0.8333333333,0,6,0.6388888889,0.75,0.8333333333,0.7361111111,6,6,6,6,0,0,0,0,2,1,1,72,56,56,72,16,1
7,14,8,8,0.5,0.875,0,8,0.8275862069,0.9655172414,0.75,0.8620689655,8,8,8,8,0,0,0,0,0,0,0,58,56,56,58,2,1
71,80,10,10,0.5454545455,1,0,10,0.9130434783,1,0.9090909091,0.9826086957,11,11,11,11,0,0,0,0,2,1,1,115,115,115,115,0,1
225,231,7,7,1,1,0,7,1,1,1,1,8,8,8,8,0,3,3,6,2,1,1,92,92,92,92,0,1
135,182,48,48,1,1,0,48,1,1,1,1,48,48,48,48,0,0,0,0,2,1,1,318,318,318,318,0,1
232,238,7,7,0.8571428571,0.8571428571,0,7,0.9104477612,0.9104477612,0.8571428571,0.9104477612,7,7,7,7,0,1,1,2,2,1,1,67,61,61,67,6,1
96,107,12,12,1,1,0,12,1,1,1,1,12,12,12,12,0,0,0,0,2,1,1,67,67,67,67,0,1
92,103,12,12,1,1,0,12,1,1,1,1,14,14,14,14,0,0,0,0,2,1,1,133,133,133,133,0,1
570,590,21,21,1,1,0,21,1,1,1,1,23,23,23,23,0,0,0,0,2,1,1,166,166,166,166,0,1
270,281,12,12,1,1,0,12,1,1,1,1,14,14,14,14,0,0,0,0,2,1,1,91,91,91,91,0,1
570,588,19,19,0.5789473684,0.9473684211,0,19,0.8695652174,0.9202898551,0.9473684211,0.9202898551,19,19,19,19,0,0,0,0,2,1,1,138,138,138,138,0,1
647,651,5,5,0.8,1,0,5,0.984375,1,0.8,0.96875,5,5,5,5,0,0,0,0,2,1,1,64,64,64,64,0,1
490,500,11,11,0.9166666667,0.9166666667,0,11,0.9857142857,0.9857142857,0.9166666667,0.9857142857,12,12,12,12,0,3,3,6,2,1,1,70,70,70,70,0,1
1697,1701,5,5,0.8,1,0,5,0.9824561404,1,1,1,5,5,5,5,0,0,0,0,2,1,1,57,57,57,57,0,1
334,367,34,34,1,1,0,34,1,1,1,1,34,34,34,34,0,0,0,0,2,1,1,350,350,350,350,0,1
148,152,5,5,0.5,0.75,0,5,0.8928571429,0.9285714286,0.25,0.7321428571,4,4,4,4,0,0,0,0,4,2,2,56,52,52,56,4,1
381,385,5,5,1,1,0,5,1,1,1,1,5,5,5,5,0,0,0,0,2,1,1,75,75,75,75,0,1
25,30,6,6,0.8571428571,1,0,6,0.9811320755,1,1,1,7,7,7,7,0,1,1,2,2,1,1,53,53,53,53,0,1
346,560,215,215,0.9951923077,0.9951923077,0,215,0.9989727786,0.9989727786,0.9951923077,0.9989727786,208,208,208,208,0,1,1,2,4,2,2,1945,1947,1945,1947,2,1
546,557,12,13,0.6153846154,0.9230769231,1,12.5,0.867768595,0.9421487603,0.3076923077,0.7603305785,13,12,12,13,1,0,0,0,2,1,1,121,114,114,121,7,1
4,12,9,10,0.5555555556,0.7777777778,1,9.5,0.7910447761,0.9253731343,0.6666666667,0.8656716418,9,9,9,9,0,0,0,0,0,0,0,63,67,63,67,4,1
396,411,16,18,0.3333333333,0.8888888889,2,17,0.8162162162,0.9243243243,0.6666666667,0.8918918919,18,16,16,18,2,0,0,0,2,1,1,185,171,171,185,14,1
62,67,6,6,0.8571428571,1,0,6,0.9830508475,1,1,1,7,7,7,7,0,1,1,2,2,1,1,59,59,59,59,0,1
529,538,10,20,0.375,0.5,10,15,0.4434782609,0.452173913,0.25,0.3956521739,16,8,8,16,8,0,0,0,2,1,1,230,104,104,230,126,1
509,525,13,17,0.4117647059,0.5294117647,4,15,0.671875,0.7109375,0.1176470588,0.5234375,13,17,13,17,4,0,0,0,2,1,1,107,128,107,128,21,1
1071,1099,29,29,1,1,0,29,1,1,1,1,29,29,29,29,0,0,0,0,2,1,1,195,195,195,195,0,1
414,433,20,20,1,1,0,20,1,1,1,1,21,21,21,21,0,0,0,0,2,1,1,189,189,189,189,0,1
261,269,9,9,1,1,0,9,1,1,1,1,11,11,11,11,0,4,4,8,2,1,1,90,90,90,90,0,1
106,114,9,9,0.7,1,0,9,0.967032967,1,1,1,10,10,10,10,0,0,0,0,2,1,1,91,91,91,91,0,1
513,562,50,50,1,1,0,50,1,1,1,1,51,51,51,51,0,0,0,0,2,1,1,451,451,451,451,0,1
522,544,18,23,0.68,0.72,5,20.5,0.7165775401,0.7326203209,0.32,0.5989304813,20,25,20,25,5,0,0,0,2,1,1,137,187,137,187,50,1
60,69,10,10,0.8,0.9,0,10,0.9166666667,0.9305555556,0.3,0.8194444444,10,10,10,10,0,0,0,0,2,1,1,68,72,68,72,4,1
61,62,2,2,0,1,0,2,0.8518518519,1,0.5,0.9814814815,2,2,2,2,0,0,0,0,2,1,1,54,54,54,54,0,1
369,379,11,13,0.5384615385,0.8461538462,2,12,0.7933884298,0.867768595,0.3076923077,0.7107438017,13,11,11,13,2,0,0,0,2,1,1,121,105,105,121,16,1
662,669,8,8,1,1,0,8,1,1,1,1,8,8,8,8,0,0,0,0,2,1,1,35,35,35,35,0,1
718,737,20,20,0.9047619048,0.9047619048,0,20,0.9495798319,0.9495798319,0.2857142857,0.6974789916,21,21,21,21,0,0,0,0,2,1,1,119,114,114,119,5,1
410,433,24,24,1,1,0,24,1,1,1,1,24,24,24,24,0,0,0,0,2,1,1,168,168,168,168,0,1
573,587,14,15,0.4,0.7333333333,1,14.5,0.5976331361,0.7041420118,0.2,0.4911242604,14,15,14,15,1,0,0,0,2,1,1,123,169,123,169,46,1
546,557,12,12,0.6666666667,1,0,12,0.9649122807,1,1,1,12,12,12,12,0,0,0,0,2,1,1,114,114,114,114,0,1
42,44,3,3,0,0.6666666667,0,3,0.75,0.9285714286,0.6666666667,0.9285714286,3,3,3,3,0,0,0,0,2,1,1,56,52,52,56,4,1
561,568,8,8,1,1,0,8,1,1,1,1,9,9,9,9,0,1,1,2,2,1,1,52,52,52,52,0,1
546,568,21,23,0.84,0.88,2,22,0.8395721925,0.871657754,0.68,0.807486631,23,25,23,25,2,0,0,0,2,1,1,166,187,166,187,21,1
1046,1164,119,119,0.9159663866,0.9915966387,0,119,0.9739884393,0.9956647399,0.9915966387,0.9927745665,119,119,119,119,0,0,0,0,2,1,1,692,691,691,692,1,1
199,206,8,8,0.625,1,0,8,0.9436619718,1,1,1,8,8,8,8,0,0,0,0,2,1,1,71,71,71,71,0,1
193,209,17,17,0.7368421053,1,0,17,0.9696969697,1,1,1,19,19,19,19,0,1,1,2,2,1,1,165,165,165,165,0,1
358,365,8,8,1,1,0,8,1,1,1,1,8,8,8,8,0,0,0,0,2,1,1,51,51,51,51,0,1
3,9,7,8,0.375,0.875,1,7.5,0.7413793103,0.8448275862,0.75,0.8103448276,8,7,7,8,1,0,0,0,0,0,0,58,49,49,58,9,1
482,486,5,7,0.5714285714,0.5714285714,2,6,0.962962963,0.962962963,0.5714285714,0.962962963,7,5,5,7,2,0,0,0,2,1,1,54,52,52,54,2,1
589,603,15,15,1,1,0,15,1,1,1,1,15,15,15,15,0,0,0,0,2,1,1,147,147,147,147,0,1
954,970,17,23,0.3043478261,0.347826087,6,20,0.663003663,0.7142857143,0.1304347826,0.5641025641,23,18,18,23,5,0,0,0,2,1,1,273,239,239,273,34,1
28,30,3,3,0.6666666667,1,0,3,0.9824561404,1,1,1,3,3,3,3,0,0,0,0,2,1,1,57,57,57,57,0,1
141,156,16,16,0.875,0.875,0,16,0.9865771812,0.9865771812,0.875,0.9865771812,16,16,16,16,0,0,0,0,2,1,1,147,149,147,149,2,1
635,648,14,14,1,1,0,14,1,1,1,1,15,15,15,15,0,2,2,4,2,1,1,80,80,80,80,0,1
407,416,10,11,0.25,0.25,1,10.5,0.3265306122,0.4795918367,0.25,0.3673469388,12,10,10,12,2,0,0,0,2,1,1,98,64,64,98,34,1
244,280,37,37,1,1,0,37,1,1,1,1,37,37,37,37,0,0,0,0,2,1,1,264,264,264,264,0,1
122,132,11,11,0.8333333333,0.9166666667,0,11,0.9196428571,0.9464285714,0.25,0.6785714286,12,12,12,12,0,0,0,0,2,1,1,112,110,110,112,2,1
492,504,12,13,0.5384615385,0.9230769231,1,12.5,0.8429752066,0.8842975207,0.9230769231,0.8842975207,12,13,12,13,1,0,0,0,2,1,1,107,121,107,121,14,1
351,359,9,9,0.4444444444,1,0,9,0.8305084746,1,1,1,9,9,9,9,0,1,1,2,2,1,1,59,59,59,59,0,1
293,304,12,12,1,1,0,12,1,1,1,1,14,14,14,14,0,0,0,0,2,1,1,91,91,91,91,0,1
200,214,15,15,1,1,0,15,1,1,1,1,15,15,15,15,0,0,0,0,2,1,1,67,67,67,67,0,1
459,472,14,14,1,1,0,14,1,1,1,1,14,14,14,14,0,0,0,0,2,1,1,128,128,128,128,0,1
522,544,21,23,0.84,0.88,2,22,0.8395721925,0.871657754,0.68,0.807486631,23,25,23,25,2,0,0,0,2,1,1,166,187,166,187,21,1
628,631,4,4,0.8333333333,0.8333333333,0,4,0.8550724638,0.8695652174,0.8333333333,0.8695652174,6,6,6,6,0,2,2,4,2,1,1,69,61,61,69,8,1
513,531,19,19,1,1,0,19,1,1,1,1,20,20,20,20,0,0,0,0,2,1,1,235,235,235,235,0,1
648,665,18,18,0.9,1,0,18,0.9854014599,1,1,1,20,20,20,20,0,0,0,0,2,1,1,137,137,137,137,0,1
1110,1122,13,13,0.8461538462,0.8461538462,0,13,0.8448275862,0.8706896552,0.1538461538,0.6637931034,13,13,13,13,0,2,2,4,2,1,1,103,116,103,116,13,1
129,151,23,23,0.76,0.76,0,23,0.7692307692,0.778280543,0.36,0.5429864253,25,25,25,25,0,0,0,0,2,1,1,221,202,202,221,19,1
1002,1026,25,25,0.8181818182,0.9545454545,0,25,0.8823529412,0.9215686275,0.9545454545,0.9117647059,22,22,22,22,0,1,1,2,0,0,0,102,94,94,102,8,1
656,667,11,12,0.5833333333,0.9166666667,1,11.5,0.8859649123,0.9210526316,0.3333333333,0.7719298246,11,12,11,12,1,0,0,0,2,1,1,105,114,105,114,9,1
648,667,20,20,0.8571428571,1,0,20,0.9806451613,1,1,1,21,21,21,21,0,1,1,2,4,2,2,155,155,155,155,0,1
132,137,6,6,0.8333333333,1,0,6,0.975,1,1,1,6,6,6,6,0,0,0,0,2,1,1,40,40,40,40,0,1
762,773,12,13,0.6153846154,0.9230769231,1,12.5,0.8595041322,0.8925619835,0.6923076923,0.8760330579,13,12,12,13,1,0,0,0,2,1,1,121,108,108,121,13,1
478,493,16,16,0.875,1,0,16,0.9761904762,1,1,1,16,16,16,16,0,0,0,0,2,1,1,84,84,84,84,0,1
37,39,3,3,0,1,0,3,0.8076923077,1,1,1,3,3,3,3,0,0,0,0,2,1,1,52,52,52,52,0,1
297,718,422,422,1,1,0,422,1,1,1,1,379,379,379,379,0,1,1,2,2,1,1,3084,3084,3084,3084,0,1
44,65,22,22,1,1,0,22,1,1,1,1,23,23,23,23,0,1,1,2,2,1,1,176,176,176,176,0,1
78,92,15,15,0.7058823529,0.9411764706,0,15,0.9108280255,0.949044586,0.2352941176,0.6687898089,17,17,17,17,0,0,0,0,2,1,1,157,149,149,157,8,1
30,36,6,7,0.2857142857,0.7142857143,1,6.5,0.5757575758,0.7575757576,0.5714285714,0.7272727273,6,7,6,7,1,0,0,0,2,1,1,26,33,26,33,7,0
159,169,11,11,0.8181818182,1,0,11,0.9661016949,1,1,1,11,11,11,11,0,1,1,2,2,1,1,59,59,59,59,0,1
250,288,39,49,1,1,10,44,1,1,1,1,18,18,18,18,0,0,0,0,4,2,2,115,115,115,115,0,1
44,50,7,7,1,1,0,7,1,1,1,1,7,7,7,7,0,0,0,0,2,1,1,35,35,35,35,0,1
308,322,15,15,1,1,0,15,1,1,1,1,15,15,15,15,0,0,0,0,2,1,1,162,162,162,162,0,1
807,816,10,10,0.5833333333,0.8333333333,0,10,0.8023255814,0.9069767442,0.3333333333,0.6860465116,12,12,12,12,0,0,0,0,2,1,1,86,86,86,86,0,1
574,583,8,10,0.4,0.7,2,9,0.5319148936,0.6382978723,0.4,0.5744680851,8,10,8,10,2,0,0,0,2,1,1,34,47,34,47,13,0
925,937,12,13,0.6923076923,0.9230769231,1,12.5,0.867768595,0.8925619835,0.6923076923,0.8760330579,12,13,12,13,1,0,0,0,2,1,1,108,121,108,121,13,1
43,52,10,10,1,1,0,10,1,1,1,1,10,10,10,10,0,0,0,0,2,1,1,88,88,88,88,0,1
28,462,435,435,1,1,0,435,1,1,1,1,367,367,367,367,0,0,0,0,0,0,0,2934,2934,2934,2934,0,1
308,322,15,15,1,1,0,15,1,1,1,1,15,15,15,15,0,0,0,0,2,1,1,162,162,162,162,0,1
92,97,6,6,0.8571428571,1,0,6,0.9836065574,1,1,1,7,7,7,7,0,1,1,2,2,1,1,61,61,61,61,0,1
754,777,24,24,1,1,0,24,1,1,1,1,24,24,24,24,0,1,1,2,2,1,1,151,151,151,151,0,1
56,58,3,3,0,0.6666666667,0,3,0.75,0.9230769231,0.6666666667,0.9038461538,3,3,3,3,0,0,0,0,2,1,1,52,48,48,52,4,1
218,223,6,6,0.7142857143,0.8571428571,0,6,0.8405797101,0.884057971,0.2857142857,0.6231884058,7,7,7,7,0,1,1,2,2,1,1,69,61,61,69,8,1
114,119,6,6,0.8571428571,1,0,6,0.9830508475,1,1,1,7,7,7,7,0,1,1,2,2,1,1,59,59,59,59,0,1
732,748,17,17,0.8235294118,0.8823529412,0,17,0.9029126214,0.9417475728,0.7058823529,0.8834951456,17,17,17,17,0,0,0,0,2,1,1,103,100,100,103,3,1
159,168,10,26,0.2,0.2,16,18,0.3802816901,0.5352112676,0.2,0.4225352113,10,10,10,10,0,0,0,0,4,2,2,60,71,60,71,11,0
940,952,13,15,0.6,0.8666666667,2,14,0.7818181818,0.8363636364,0.6666666667,0.7454545455,15,13,13,15,2,0,0,0,2,1,1,110,92,92,110,18,1
822,874,53,53,0.8285714286,0.9714285714,0,53,0.9380530973,0.9778761062,0.4857142857,0.7522123894,35,35,35,35,0,1,1,2,3,1,2,225,226,225,226,1,1
130,136,7,8,0.5555555556,0.7777777778,1,7.5,0.9058823529,0.9411764706,0.5555555556,0.9176470588,9,8,8,9,1,0,0,0,2,1,1,85,83,83,85,2,1
109,117,9,9,0.6666666667,0.8888888889,0,9,0.7619047619,0.8888888889,0,0.7936507937,9,9,9,9,0,0,0,0,2,1,1,63,63,63,63,0,0
463,480,18,18,1,1,0,18,1,1,1,1,18,18,18,18,0,0,0,0,2,1,1,99,99,99,99,0,1
677,737,61,61,0.7333333333,0.9833333333,0,61,0.9756410256,0.9961538462,0.9833333333,0.9961538462,60,60,60,60,0,1,1,2,3,2,1,780,780,780,780,0,1
76,81,6,6,0.8571428571,1,0,6,0.9830508475,1,1,1,7,7,7,7,0,1,1,2,2,1,1,59,59,59,59,0,1
655,670,16,16,1,1,0,16,1,1,1,1,17,17,17,17,0,2,2,4,2,1,1,98,98,98,98,0,1
565,585,21,21,1,1,0,21,1,1,1,1,23,23,23,23,0,0,0,0,2,1,1,166,166,166,166,0,1
160,160,1,1,1,1,0,1,1,1,1,1,1,1,1,1,0,0,0,0,0,0,0,330,330,330,330,0,1
39,47,9,9,0.5555555556,0.5555555556,0,9,0.7717391304,0.8152173913,0.5555555556,0.7934782609,9,9,9,9,0,0,0,0,4,2,2,85,92,85,92,7,1
165,175,11,11,0.7272727273,0.7272727273,0,11,0.8453038674,0.9281767956,0.7272727273,0.9281767956,11,11,11,11,0,0,1,1,0,0,0,181,175,175,181,6,1
1525,1530,6,6,0.8,1,0,6,0.9791666667,1,1,1,5,5,5,5,0,1,1,2,2,1,1,48,48,48,48,0,1
650,667,18,23,0.68,0.72,5,20.5,0.7165775401,0.7326203209,0.32,0.5989304813,25,20,20,25,5,0,0,0,2,1,1,187,137,137,187,50,1
539,546,8,8,0.8888888889,1,0,8,0.9807692308,1,1,1,9,9,9,9,0,1,1,2,2,1,1,52,52,52,52,0,1
108,122,15,15,0.7647058824,1,0,15,0.9738562092,1,1,1,17,17,17,17,0,1,1,2,2,1,1,153,153,153,153,0,1
1532,1546,15,17,0.6470588235,0.8235294118,2,16,0.838028169,0.9084507042,0.5882352941,0.8591549296,17,15,15,17,2,0,0,0,2,1,1,142,129,129,142,13,1
1548,1565,18,19,0.6315789474,0.8947368421,1,18.5,0.8933333333,0.9533333333,0.3157894737,0.8266666667,19,18,18,19,1,0,0,0,2,1,1,150,144,144,150,6,1
647,653,7,7,0.5714285714,1,0,7,0.9436619718,1,1,1,7,7,7,7,0,1,1,2,2,1,1,71,71,71,71,0,1
495,511,17,17,0.7647058824,0.7647058824,0,17,0.925,0.925,0.2352941176,0.75,17,17,17,17,0,1,1,2,2,1,1,148,160,148,160,12,1
835,853,19,19,1,1,0,19,1,1,1,1,19,19,19,19,0,3,3,6,2,1,1,171,171,171,171,0,1
672,685,14,14,1,1,0,14,1,1,1,1,15,15,15,15,0,2,2,4,2,1,1,78,78,78,78,0,1
78,96,17,19,0.6842105263,0.8421052632,2,18,0.8260869565,0.8985507246,0.6315789474,0.847826087,17,19,17,19,2,0,0,0,2,1,1,125,138,125,138,13,1
1151,1156,6,6,0.5,0.8333333333,0,6,0.6388888889,0.75,0.8333333333,0.7361111111,6,6,6,6,0,0,0,0,2,1,1,72,56,56,72,16,1
1301,1309,9,9,1,1,0,9,1,1,1,1,9,9,9,9,0,0,0,0,2,1,1,83,83,83,83,0,1
36,41,6,6,1,1,0,6,1,1,1,1,7,7,7,7,0,0,0,0,2,1,1,62,62,62,62,0,1
667,685,19,23,0.68,0.72,4,21,0.7326203209,0.7754010695,0.32,0.6256684492,25,21,21,25,4,0,0,0,2,1,1,187,149,149,187,38,1
367,390,24,24,1,1,0,24,1,1,1,1,24,24,24,24,0,0,0,0,2,1,1,344,344,344,344,0,1
208,211,4,4,0.75,0.75,0,4,0.75,0.9342105263,0.75,0.8684210526,4,4,4,4,0,0,0,0,2,1,1,74,76,74,76,2,1
927,941,15,15,0.6,1,0,15,0.9346405229,1,1,1,15,15,15,15,0,0,0,0,2,1,1,153,153,153,153,0,1
406,441,36,36,1,1,0,36,1,1,1,1,38,38,38,38,0,0,0,0,2,1,1,349,349,349,349,0,1
199,206,8,8,0.625,1,0,8,0.9436619718,1,1,1,8,8,8,8,0,0,0,0,2,1,1,71,71,71,71,0,1
202,209,8,8,0.7777777778,0.8888888889,0,8,0.9240506329,0.9367088608,0.3333333333,0.7974683544,9,9,9,9,0,0,0,0,2,1,1,79,74,74,79,5,1
573,587,15,15,1,1,0,15,1,1,1,1,15,15,15,15,0,0,0,0,2,1,1,147,147,147,147,0,1
230,235,6,6,0.8571428571,1,0,6,0.9836065574,1,1,1,7,7,7,7,0,1,1,2,2,1,1,61,61,61,61,0,1
110,260,151,151,1,1,0,151,1,1,1,1,142,142,142,142,0,1,1,2,4,2,2,1042,1042,1042,1042,0,1
104,120,17,17,0.7368421053,1,0,17,0.9698795181,1,1,1,19,19,19,19,0,1,1,2,2,1,1,166,166,166,166,0,1
64,71,8,9,0.5555555556,0.6666666667,1,8.5,0.8387096774,0.8548387097,0.6666666667,0.8548387097,9,9,9,9,0,0,0,0,2,1,1,62,62,62,62,0,1
216,229,14,14,1,1,0,14,1,1,1,1,14,14,14,14,0,0,0,0,2,1,1,107,107,107,107,0,1
84,91,8,8,1,1,0,8,1,1,1,1,8,8,8,8,0,0,0,0,2,1,1,67,67,67,67,0,1
48,62,15,15,1,1,0,15,1,1,1,1,16,16,16,16,0,0,0,0,2,1,1,119,119,119,119,0,1
154,159,6,6,1,1,0,6,1,1,1,1,6,6,6,6,0,1,1,2,2,1,1,37,37,37,37,0,1
60,64,5,5,0.6666666667,1,0,5,0.9677419355,1,1,1,6,6,6,6,0,2,2,4,2,1,1,62,62,62,62,0,1
23,117,95,95,1,1,0,95,1,1,1,1,99,99,99,99,0,0,0,0,2,1,1,817,817,817,817,0,1
177,215,32,39,0.0869565217,0.1304347826,7,35.5,0.206741573,0.3146067416,0.0869565217,0.2179775281,32,46,32,46,14,0,0,0,2,1,1,191,445,191,445,254,0
24,132,109,109,1,1,0,109,1,1,1,1,114,114,114,114,0,0,0,0,2,1,1,999,999,999,999,0,1
667,685,19,21,0.7391304348,0.7826086957,2,20,0.8192771084,0.8614457831,0.347826087,0.6987951807,23,21,21,23,2,0,0,0,2,1,1,166,149,149,166,17,1
209,223,15,15,0.9333333333,0.9333333333,0,15,0.980952381,0.980952381,0.0666666667,0.7619047619,15,15,15,15,0,0,0,0,2,1,1,206,210,206,210,4,1
43,52,10,10,1,1,0,10,1,1,1,1,10,10,10,10,0,0,0,0,2,1,1,88,88,88,88,0,1
197,219,23,23,1,1,0,23,1,1,1,1,25,25,25,25,0,0,0,0,2,1,1,202,202,202,202,0,1
651,668,18,18,0.3333333333,1,0,18,0.9243243243,1,1,1,18,18,18,18,0,0,0,0,2,1,1,185,185,185,185,0,1
73,114,40,42,0.7619047619,0.9523809524,2,41,0.8544303797,0.8860759494,0.6428571429,0.7436708861,40,42,40,42,2,0,0,0,2,1,1,280,316,280,316,36,1
496,500,5,5,1,1,0,5,1,1,1,1,5,5,5,5,0,0,0,0,2,1,1,53,53,53,53,0,1
112,134,23,23,0.6923076923,0.9615384615,0,23,0.9608695652,0.9913043478,0.9230769231,0.9869565217,26,26,26,26,0,1,1,2,2,1,1,230,230,230,230,0,1
134,145,8,12,0,0.0769230769,4,10,0.3170731707,0.5609756098,0,0.4146341463,8,13,8,13,5,3,1,4,2,1,1,82,80,80,82,2,0
537,544,8,8,0.8888888889,1,0,8,0.9807692308,1,1,1,9,9,9,9,0,1,1,2,2,1,1,52,52,52,52,0,1
675,688,14,14,1,1,0,14,1,1,1,1,15,15,15,15,0,0,0,0,2,1,1,86,86,86,86,0,1
272,288,17,18,0.3333333333,0.9444444444,1,17.5,0.8540540541,0.9621621622,0.7222222222,0.9297297297,18,17,17,18,1,0,0,0,2,1,1,185,178,178,185,7,1
387,446,60,60,0,0,0,60,0.5714285714,0.8571428571,0,0.6261904762,60,60,60,60,0,0,0,0,2,1,1,420,420,420,420,0,0
175,180,6,6,1,1,0,6,1,1,1,1,6,6,6,6,0,0,0,0,2,1,1,50,50,50,50,0,1
736,753,18,18,0.3333333333,0.9444444444,0,18,0.7621621622,0.9675675676,0.3888888889,0.8162162162,18,18,18,18,0,0,0,0,2,1,1,185,179,179,185,6,1
574,584,11,11,0.8181818182,1,0,11,0.984375,1,1,1,11,11,11,11,0,1,1,2,2,1,1,128,128,128,128,0,1
214,221,8,8,1,1,0,8,1,1,1,1,8,8,8,8,0,0,0,0,2,1,1,44,44,44,44,0,1
162,214,53,53,1,1,0,53,1,1,1,1,50,50,50,50,0,1,1,2,2,1,1,324,324,324,324,0,0
18,52,35,35,0.9714285714,0.9714285714,0,35,0.9677419355,0.9765395894,0.2571428571,0.7390029326,35,35,35,35,0,0,0,0,2,1,1,341,335,335,341,6,1
36,41,6,6,1,1,0,6,1,1,1,1,7,7,7,7,0,0,0,0,2,1,1,62,62,62,62,0,1
552,557,6,6,0.8333333333,1,0,6,0.9824561404,1,1,1,6,6,6,6,0,1,1,2,2,1,1,57,57,57,57,0,1
126,138,13,13,1,1,0,13,1,1,1,1,13,13,13,13,0,0,0,0,2,1,1,111,111,111,111,0,1
211,217,7,7,0.7142857143,1,0,7,0.9714285714,1,1,1,7,7,7,7,0,1,1,2,2,1,1,70,70,70,70,0,1
648,665,18,21,0.7391304348,0.7826086957,3,19.5,0.7951807229,0.813253012,0.347826087,0.656626506,23,20,20,23,3,0,0,0,2,1,1,166,137,137,166,29,1
73,89,17,17,1,1,0,17,1,1,1,1,20,20,20,20,0,0,0,0,4,2,2,158,158,158,158,0,1
360,567,189,208,0.4326923077,0.7211538462,19,198.5,0.7158071749,0.8206278027,0.6442307692,0.7864349776,189,208,189,208,19,0,0,0,2,1,1,1713,1784,1713,1784,71,0
819,850,32,32,1,1,0,32,1,1,1,1,32,32,32,32,0,0,0,0,2,1,1,357,357,357,357,0,1
115,121,7,7,0.625,1,0,7,0.9473684211,1,1,1,8,8,8,8,0,1,1,2,2,1,1,76,76,76,76,0,1
416,526,110,111,0.2702702703,0.7027027027,1,110.5,0.4742857143,0.6392857143,0.045045045,0.4014285714,110,111,110,111,1,0,0,0,2,1,1,1400,1097,1097,1400,303,0
413,443,31,31,1,1,0,31,1,1,1,1,32,32,32,32,0,1,1,2,2,1,1,227,227,227,227,0,1
65,71,7,7,1,1,0,7,1,1,1,1,7,7,7,7,0,2,2,4,2,1,1,66,66,66,66,0,1
1498,1510,13,15,0.6428571429,0.7857142857,2,14,0.8455284553,0.8780487805,0.2142857143,0.7235772358,14,12,12,14,2,1,1,2,2,1,1,123,109,109,123,14,1
792,814,23,23,1,1,0,23,1,1,1,1,12,12,12,12,0,0,0,0,4,2,2,79,79,79,79,0,0
338,361,24,24,1,1,0,24,1,1,1,1,24,24,24,24,0,0,0,0,2,1,1,168,168,168,168,0,0
316,333,17,18,0.6111111111,0.9444444444,1,17.5,0.9297297297,0.9621621622,0.7222222222,0.9297297297,17,18,17,18,1,0,0,0,2,1,1,178,185,178,185,7,1
388,413,26,26,1,1,0,26,1,1,1,1,26,26,26,26,0,0,0,0,2,1,1,182,182,182,182,0,0
459,472,13,14,0.7142857143,0.7857142857,1,13.5,0.8796992481,0.9172932331,0.5714285714,0.7969924812,13,14,13,14,1,0,0,0,2,1,1,133,128,128,133,5,1
94,110,17,17,0.7368421053,1,0,17,0.9698795181,1,1,1,19,19,19,19,0,1,1,2,2,1,1,166,166,166,166,0,0
203,224,22,22,0.8571428571,0.9523809524,0,22,0.9333333333,0.9555555556,0.2380952381,0.5555555556,21,21,21,21,0,2,2,4,4,2,2,225,216,216,225,9,0
600,606,7,7,0.4285714286,0.7142857143,0,7,0.8309859155,0.8591549296,0.2857142857,0.8028169014,7,7,7,7,0,0,0,0,2,1,1,63,71,63,71,8,1
383,393,11,11,1,1,0,11,1,1,1,1,11,11,11,11,0,0,0,0,2,1,1,133,133,133,133,0,1
194,203,10,10,1,1,0,10,1,1,1,1,8,8,8,8,0,0,0,0,2,1,1,59,59,59,59,0,1
259,270,12,12,0.75,0.75,0,12,0.8611111111,0.875,0.3333333333,0.6527777778,12,12,12,12,0,0,0,0,2,1,1,63,72,63,72,9,1
132,140,9,9,1,1,0,9,1,1,1,1,11,11,11,11,0,0,0,0,2,1,1,129,129,129,129,0,1
62,64,3,3,0,1,0,3,0.85,1,1,1,3,3,3,3,0,0,0,0,2,1,1,60,60,60,60,0,1
75,84,10,10,1,1,0,10,1,1,1,1,12,12,12,12,0,0,0,0,2,1,1,79,79,79,79,0,1
132,140,9,9,1,1,0,9,1,1,1,1,11,11,11,11,0,0,0,0,2,1,1,129,129,129,129,0,1
667,685,18,19,0.8571428571,0.9047619048,1,18.5,0.8724832215,0.8926174497,0.7142857143,0.8187919463,20,21,20,21,1,0,0,0,2,1,1,137,149,137,149,12,1
238,248,11,12,0.3076923077,0.7692307692,1,11.5,0.6883116883,0.8311688312,0.7692307692,0.8311688312,13,12,12,13,1,0,0,0,2,1,1,77,71,71,77,6,1
422,430,9,13,0.2307692308,0.3076923077,4,11,0.4027777778,0.625,0.3076923077,0.5277777778,13,10,10,13,3,0,0,0,2,1,1,72,60,60,72,12,0
142,158,17,17,0.5789473684,1,0,17,0.9375,1,1,1,19,19,19,19,0,0,0,0,2,1,1,160,160,160,160,0,0
62,78,17,17,0.7368421053,1,0,17,0.9696969697,1,1,1,19,19,19,19,0,1,1,2,2,1,1,165,165,165,165,0,0
474,483,10,10,1,1,0,10,1,1,1,1,11,11,11,11,0,0,0,0,2,1,1,78,78,78,78,0,1
296,317,22,22,1,1,0,22,1,1,1,1,21,21,21,21,0,3,3,6,4,2,2,158,158,158,158,0,1
662,680,18,19,0.8571428571,0.9047619048,1,18.5,0.8724832215,0.8926174497,0.7142857143,0.8187919463,20,21,20,21,1,0,0,0,2,1,1,137,149,137,149,12,1
153,159,7,7,0.875,1,0,7,0.9852941176,1,1,1,8,8,8,8,0,1,1,2,2,1,1,68,68,68,68,0,1
216,229,14,14,1,1,0,14,1,1,1,1,14,14,14,14,0,0,0,0,2,1,1,107,107,107,107,0,1
1258,1272,15,15,1,1,0,15,1,1,1,1,16,16,16,16,0,0,0,0,2,1,1,176,176,176,176,0,1
925,937,13,13,0.6153846154,0.9230769231,0,13,0.9426229508,0.9918032787,0.6923076923,0.9508196721,13,13,13,13,0,0,0,0,2,1,1,122,121,121,122,1,1
522,546,25,25,0.8461538462,1,0,25,0.9759615385,1,1,1,26,26,26,26,0,1,1,2,4,2,2,208,208,208,208,0,1
184,194,11,11,0.5,1,0,11,0.9135802469,1,1,1,10,10,10,10,0,2,2,4,4,2,2,81,81,81,81,0,1
722,749,26,28,0.4827586207,0.6206896552,2,27,0.752851711,0.8365019011,0.2413793103,0.63878327,28,29,28,29,1,0,0,0,2,1,1,257,263,257,263,6,1
440,452,13,13,1,1,0,13,1,1,1,1,13,13,13,13,0,0,0,0,2,1,1,133,133,133,133,0,1
20,39,20,20,0.95,1,0,20,0.9937888199,1,1,1,20,20,20,20,0,2,2,4,2,1,1,161,161,161,161,0,1
1256,1267,12,12,1,1,0,12,1,1,1,1,13,13,13,13,0,0,0,0,2,1,1,83,83,83,83,0,1
1525,1530,6,6,0.8,1,0,6,0.9791666667,1,1,1,5,5,5,5,0,1,1,2,2,1,1,48,48,48,48,0,1
48,62,15,15,1,1,0,15,1,1,1,1,16,16,16,16,0,0,0,0,2,1,1,119,119,119,119,0,1
985,990,6,6,0.8,1,0,6,0.9791666667,1,1,1,5,5,5,5,0,1,1,2,2,1,1,48,48,48,48,0,1
213,224,12,12,1,1,0,12,1,1,1,1,12,12,12,12,0,4,4,8,2,1,1,87,87,87,87,0,0
232,302,71,71,1,1,0,71,1,1,1,1,69,69,69,69,0,0,0,0,4,2,2,504,504,504,504,0,1
140,143,4,4,1,1,0,4,1,1,1,1,4,4,4,4,0,1,1,2,2,1,1,58,58,58,58,0,1
110,118,9,9,0.7,1,0,9,0.9655172414,1,1,1,10,10,10,10,0,1,1,2,2,1,1,87,87,87,87,0,1
489,492,4,4,0.8333333333,0.8333333333,0,4,0.8550724638,0.8695652174,0.8333333333,0.8695652174,6,6,6,6,0,2,2,4,2,1,1,61,69,61,69,8,1
424,453,30,30,1,1,0,30,1,1,1,1,30,30,30,30,0,0,0,0,2,1,1,210,210,210,210,0,0
157,167,11,11,0.5454545455,0.9090909091,0,11,0.7659574468,0.8723404255,0.9090909091,0.8723404255,11,11,11,11,0,1,0,1,2,1,1,94,84,84,94,10,1
118,126,9,9,1,1,0,9,1,1,1,1,9,9,9,9,0,0,0,0,2,1,1,115,115,115,115,0,1
440,452,13,13,1,1,0,13,1,1,1,1,13,13,13,13,0,0,0,0,2,1,1,133,133,133,133,0,1
1,68,68,68,1,1,0,68,1,1,1,1,47,47,47,47,0,0,0,0,0,0,0,325,325,325,325,0,1
92,101,10,12,0.1538461538,0.3846153846,2,11,0.3473684211,0.5578947368,0.1538461538,0.4105263158,13,11,11,13,2,0,0,0,2,1,1,95,72,72,95,23,0
444,453,10,10,0.75,0.8333333333,0,10,0.8953488372,0.9534883721,0.3333333333,0.7325581395,12,12,12,12,0,0,0,0,2,1,1,86,82,82,86,4,1
173,190,18,18,0.9444444444,1,0,18,0.9944751381,1,1,1,18,18,18,18,0,0,0,0,2,1,1,181,181,181,181,0,1
1,204,204,204,1,1,0,204,1,1,1,1,185,185,185,185,0,0,0,0,0,0,0,1550,1550,1550,1550,0,0
90,95,6,6,0.8571428571,1,0,6,0.9830508475,1,1,1,7,7,7,7,0,1,1,2,2,1,1,59,59,59,59,0,1
407,436,30,30,0.5217391304,1,0,30,0.912195122,1,1,1,23,23,23,23,0,1,1,2,4,2,2,205,205,205,205,0,1
925,937,11,13,0.5384615385,0.8461538462,2,12,0.7933884298,0.867768595,0.3076923077,0.7107438017,11,13,11,13,2,0,0,0,2,1,1,105,121,105,121,16,1
1,604,604,604,1,1,0,604,1,1,1,1,546,546,546,546,0,0,0,0,0,0,0,4947,4947,4947,4947,0,1
413,448,36,36,1,1,0,36,1,1,1,1,38,38,38,38,0,0,0,0,2,1,1,349,349,349,349,0,1
548,570,18,23,0.68,0.72,5,20.5,0.7165775401,0.7326203209,0.32,0.5989304813,20,25,20,25,5,0,0,0,2,1,1,137,187,137,187,50,1
113,124,12,12,1,1,0,12,1,1,1,1,12,12,12,12,0,0,0,0,2,1,1,67,67,67,67,0,1
119,136,16,18,0.4444444444,0.8333333333,2,17,0.595505618,0.6966292135,0.5,0.606741573,16,18,16,18,2,0,0,0,2,1,1,64,89,64,89,25,1
910,922,12,13,0.5384615385,0.9230769231,1,12.5,0.8347107438,0.9256198347,0.3846153846,0.7685950413,12,13,12,13,1,0,0,0,2,1,1,112,121,112,121,9,1
263,275,13,29,0.1379310345,0.2068965517,16,21,0.3058252427,0.4708737864,0.1379310345,0.354368932,29,14,14,29,15,0,0,0,2,1,1,206,105,105,206,101,0
488,494,7,7,1,1,0,7,1,1,1,1,7,7,7,7,0,0,0,0,2,1,1,51,51,51,51,0,1
132,138,7,7,0.625,1,0,7,0.9240506329,1,1,1,8,8,8,8,0,0,0,0,2,1,1,79,79,79,79,0,1
1015,1020,6,6,0.8,1,0,6,0.9791666667,1,1,1,5,5,5,5,0,1,1,2,2,1,1,48,48,48,48,0,1
1097,1113,16,17,0.6470588235,0.7647058824,1,16.5,0.8035714286,0.8660714286,0.2352941176,0.625,16,17,16,17,1,0,0,0,2,1,1,108,112,108,112,4,1
248,261,12,14,0.5,0.7857142857,2,13,0.7697841727,0.8201438849,0.3571428571,0.7050359712,12,14,12,14,2,0,0,0,2,1,1,115,139,115,139,24,1
24,69,46,46,1,1,0,46,1,1,1,1,40,40,40,40,0,0,0,0,0,0,0,276,276,276,276,0,1
522,544,23,23,1,1,0,23,1,1,1,1,25,25,25,25,0,0,0,0,2,1,1,187,187,187,187,0,1
606,619,14,14,1,1,0,14,1,1,1,1,15,15,15,15,0,0,0,0,2,1,1,131,131,131,131,0,1
99,128,30,30,1,1,0,30,1,1,1,1,24,24,24,24,0,1,1,2,4,2,2,192,192,192,192,0,1
546,568,18,23,0.68,0.72,5,20.5,0.7165775401,0.7326203209,0.32,0.5989304813,20,25,20,25,5,0,0,0,2,1,1,137,187,137,187,50,1
520,525,6,6,0.8333333333,0.8333333333,0,6,0.8360655738,0.893442623,0.1666666667,0.737704918,6,6,6,6,0,0,0,0,4,2,2,113,122,113,122,9,1
1009,1041,17,33,0,0,16,25,0.2727272727,0.5454545455,0,0.449197861,17,17,17,17,0,0,0,0,0,0,0,187,136,136,187,51,0
38,72,13,35,0.0833333333,0.1111111111,22,24,0.203125,0.30859375,0.0833333333,0.23828125,13,36,13,36,23,0,0,0,2,1,1,90,256,90,256,166,0
75,84,10,10,1,1,0,10,1,1,1,1,12,12,12,12,0,0,0,0,2,1,1,79,79,79,79,0,1
629,646,18,23,0.68,0.72,5,20.5,0.7165775401,0.7326203209,0.32,0.5989304813,25,20,20,25,5,0,0,0,2,1,1,187,137,137,187,50,1
367,393,27,27,1,1,0,27,1,1,1,1,27,27,27,27,0,1,1,2,2,1,1,351,351,351,351,0,1
93,110,18,18,1,1,0,18,1,1,1,1,18,18,18,18,0,2,2,4,2,1,1,113,113,113,113,0,1
629,646,18,19,0.8571428571,0.9047619048,1,18.5,0.8724832215,0.8926174497,0.7142857143,0.8187919463,21,20,20,21,1,0,0,0,2,1,1,149,137,137,149,12,1
308,322,15,15,1,1,0,15,1,1,1,1,15,15,15,15,0,0,0,0,2,1,1,162,162,162,162,0,1
4,201,198,198,1,1,0,198,1,1,1,1,181,181,181,181,0,3,3,6,2,1,1,1533,1533,1533,1533,0,1
162,167,6,6,0.7142857143,1,0,6,0.9275362319,1,1,1,7,7,7,7,0,1,1,2,2,1,1,69,69,69,69,0,1
1512,1529,14,18,0.5,0.7222222222,4,16,0.777027027,0.8175675676,0.3888888889,0.722972973,14,18,14,18,4,0,0,0,2,1,1,122,148,122,148,26,1
569,583,15,16,0.375,0.8125,1,15.5,0.649122807,0.8362573099,0.25,0.5204678363,16,15,15,16,1,0,0,0,2,1,1,171,148,148,171,23,1
595,618,24,24,1,1,0,24,1,1,1,1,26,26,26,26,0,0,0,0,2,1,1,175,175,175,175,0,1
984,998,15,15,0,1,0,15,0.7142857143,1,1,1,15,15,15,15,0,0,0,0,2,1,1,105,105,105,105,0,0
604,617,14,14,1,1,0,14,1,1,1,1,15,15,15,15,0,0,0,0,2,1,1,131,131,131,131,0,1
648,665,18,23,0.68,0.72,5,20.5,0.7165775401,0.7326203209,0.32,0.5989304813,25,20,20,25,5,0,0,0,2,1,1,187,137,137,187,50,1
271,298,28,28,0.75,1,0,28,0.966507177,1,1,1,28,28,28,28,0,1,1,2,0,0,0,209,209,209,209,0,1
187,203,14,17,0.4117647059,0.7647058824,3,15.5,0.7417582418,0.7967032967,0.4705882353,0.7417582418,14,17,14,17,3,0,0,0,2,1,1,145,182,145,182,37,1
7,178,172,172,1,1,0,172,1,1,1,1,180,180,180,180,0,2,2,4,2,1,1,1608,1608,1608,1608,0,1
474,483,10,10,1,1,0,10,1,1,1,1,11,11,11,11,0,0,0,0,2,1,1,78,78,78,78,0,1
90,172,83,83,1,1,0,83,1,1,1,1,83,83,83,83,0,0,0,0,2,1,1,756,756,756,756,0,1
522,544,23,23,1,1,0,23,1,1,1,1,25,25,25,25,0,0,0,0,2,1,1,187,187,187,187,0,1
208,241,34,34,1,1,0,34,1,1,1,1,35,35,35,35,0,0,0,0,2,1,1,387,387,387,387,0,1
7,876,870,870,0.9988235294,0.9988235294,0,870,0.9969040248,0.9969040248,0.9988235294,0.9969040248,850,850,850,850,0,3,2,5,2,1,1,7085,7106,7085,7106,21,1
3,37,35,35,1,1,0,35,1,1,1,1,35,35,35,35,0,0,0,0,2,1,1,320,320,320,320,0,1
413,448,36,36,1,1,0,36,1,1,1,1,38,38,38,38,0,0,0,0,2,1,1,349,349,349,349,0,1
1096,1105,10,10,0.4,1,0,10,0.8222222222,1,1,1,10,10,10,10,0,0,0,0,2,1,1,90,90,90,90,0,1
629,646,18,19,0.8571428571,0.9047619048,1,18.5,0.8724832215,0.8926174497,0.7142857143,0.8187919463,21,20,20,21,1,0,0,0,2,1,1,149,137,137,149,12,1
395,405,11,12,0.5833333333,0.8333333333,1,11.5,0.8240740741,0.9351851852,0.3333333333,0.75,12,11,11,12,1,0,0,0,2,1,1,108,105,105,108,3,1
316,325,10,10,1,1,0,10,1,1,1,1,10,10,10,10,0,0,0,0,2,1,1,115,115,115,115,0,1
762,773,12,12,0.5833333333,0.8333333333,0,12,0.7542372881,0.8813559322,0.3333333333,0.6949152542,12,12,12,12,0,0,0,0,2,1,1,118,108,108,118,10,1
536,548,13,13,0.8461538462,1,0,13,0.9805825243,1,1,1,13,13,13,13,0,2,2,4,2,1,1,103,103,103,103,0,1
24,66,43,43,1,1,0,43,1,1,1,1,38,38,38,38,0,2,2,4,2,1,1,274,274,274,274,0,1
1053,1065,13,13,0.8461538462,1,0,13,0.9805825243,1,1,1,13,13,13,13,0,2,2,4,2,1,1,103,103,103,103,0,1
260,270,11,11,1,1,0,11,1,1,1,1,11,11,11,11,0,0,0,0,2,1,1,95,95,95,95,0,1
159,173,15,15,1,1,0,15,1,1,1,1,15,15,15,15,0,0,0,0,2,1,1,190,190,190,190,0,1
146,162,17,17,0.6315789474,0.9473684211,0,17,0.9537572254,0.9884393064,0.9473684211,0.9884393064,19,19,19,19,0,1,1,2,2,1,1,173,173,173,173,0,1
894,907,14,14,0.5714285714,0.7857142857,0,14,0.8139534884,0.8449612403,0.3571428571,0.7054263566,14,14,14,14,0,0,0,0,2,1,1,109,129,109,129,20,1
71,83,13,13,1,1,0,13,1,1,1,1,13,13,13,13,0,0,0,0,2,1,1,96,96,96,96,0,1
461,501,41,41,1,1,0,41,1,1,1,1,41,41,41,41,0,0,0,0,2,1,1,287,287,287,287,0,1
194,206,13,13,1,1,0,13,1,1,1,1,14,14,14,14,0,0,0,0,2,1,1,83,83,83,83,0,1
742,745,4,4,0.25,1,0,4,0.9835164835,1,1,1,4,4,4,4,0,0,0,0,2,1,1,182,182,182,182,0,1
23,59,37,37,1,1,0,37,1,1,1,1,35,35,35,35,0,4,4,8,2,1,1,393,393,393,393,0,1
560,571,12,12,0.5,0.9166666667,0,12,0.8571428571,0.9579831933,0.3333333333,0.781512605,12,12,12,12,0,0,0,0,2,1,1,119,114,114,119,5,1
590,599,10,10,0.9090909091,0.9090909091,0,10,0.9863013699,0.9863013699,0.9090909091,0.9863013699,11,11,11,11,0,0,0,0,2,1,1,72,73,72,73,1,1
220,231,12,12,0.5833333333,0.8333333333,0,12,0.7542372881,0.8813559322,0.3333333333,0.6949152542,12,12,12,12,0,0,0,0,2,1,1,108,118,108,118,10,1
21,30,10,10,1,1,0,10,1,1,1,1,12,12,12,12,0,0,0,0,2,1,1,121,121,121,121,0,1
110,197,88,88,1,1,0,88,1,1,1,1,88,88,88,88,0,0,0,0,2,1,1,484,484,484,484,0,1
424,434,11,11,1,1,0,11,1,1,1,1,11,11,11,11,0,1,1,2,2,1,1,107,107,107,107,0,1
348,363,16,16,1,1,0,16,1,1,1,1,16,16,16,16,0,0,0,0,2,1,1,149,149,149,149,0,1
643,653,11,11,0.8461538462,0.9230769231,0,11,0.9595959596,0.9696969697,0.9230769231,0.9696969697,13,13,13,13,0,0,0,0,2,1,1,99,99,99,99,0,1
886,896,11,11,1,1,0,11,1,1,1,1,12,12,12,12,0,0,0,0,2,1,1,57,57,57,57,0,1
116,121,6,6,0.7142857143,0.8571428571,0,6,0.8405797101,0.884057971,0.2857142857,0.6231884058,7,7,7,7,0,1,1,2,2,1,1,69,61,61,69,8,0
617,627,11,11,0.8461538462,0.9230769231,0,11,0.9595959596,0.9696969697,0.9230769231,0.9696969697,13,13,13,13,0,0,0,0,2,1,1,99,99,99,99,0,1
227,235,9,9,0.8888888889,0.8888888889,0,9,0.9852941176,0.9852941176,0.8888888889,0.9852941176,9,9,9,9,0,5,5,10,2,1,1,136,134,134,136,2,1
384,413,30,30,1,1,0,30,1,1,1,1,30,30,30,30,0,0,0,0,2,1,1,210,210,210,210,0,1
138,153,16,16,0.6875,0.875,0,16,0.9333333333,0.9703703704,0.0625,0.7481481481,16,16,16,16,0,0,0,0,2,1,1,135,133,133,135,2,1
414,433,20,20,1,1,0,20,1,1,1,1,21,21,21,21,0,0,0,0,2,1,1,189,189,189,189,0,1
159,173,15,15,1,1,0,15,1,1,1,1,15,15,15,15,0,0,0,0,2,1,1,190,190,190,190,0,1
18,29,12,13,0.3846153846,0.7692307692,1,12.5,0.5675675676,0.7432432432,0.7692307692,0.7027027027,13,12,12,13,1,0,0,0,2,1,1,74,58,58,74,16,1
133,154,22,22,0.9545454545,1,0,22,0.9935897436,1,1,1,22,22,22,22,0,3,3,6,2,1,1,156,156,156,156,0,1
319,328,10,10,0.9,0.9,0,10,0.9579831933,0.9579831933,0.9,0.9579831933,10,10,10,10,0,0,0,0,2,1,1,115,119,115,119,4,1
744,757,14,14,0.9333333333,0.9333333333,0,14,0.9736842105,0.9736842105,0.9333333333,0.9736842105,15,15,15,15,0,0,0,0,2,1,1,76,76,76,76,0,1
568,578,11,11,1,1,0,11,1,1,1,1,13,13,13,13,0,0,0,0,2,1,1,87,87,87,87,0,1
770,796,27,27,1,1,0,27,1,1,1,1,27,27,27,27,0,0,0,0,2,1,1,232,232,232,232,0,1
648,665,18,23,0.68,0.72,5,20.5,0.7165775401,0.7326203209,0.32,0.5989304813,25,20,20,25,5,0,0,0,2,1,1,187,137,137,187,50,1
524,546,23,23,0.88,1,0,23,0.9786096257,1,1,1,25,25,25,25,0,0,0,0,2,1,1,187,187,187,187,0,1
46,59,14,14,1,1,0,14,1,1,1,1,14,14,14,14,0,0,0,0,2,1,1,184,184,184,184,0,1
104,120,17,17,0.7368421053,1,0,17,0.9696969697,1,1,1,19,19,19,19,0,1,1,2,2,1,1,165,165,165,165,0,1
795,809,15,15,1,1,0,15,1,1,1,1,19,19,19,19,0,0,0,0,2,1,1,154,154,154,154,0,1
771,797,27,27,1,1,0,27,1,1,1,1,27,27,27,27,0,0,0,0,2,1,1,232,232,232,232,0,1
151,163,13,13,0.5384615385,0.7692307692,0,13,0.7337662338,0.8311688312,0.4615384615,0.7142857143,13,13,13,13,0,0,0,0,2,1,1,139,154,139,154,15,1
1257,1267,11,11,1,1,0,11,1,1,1,1,12,12,12,12,0,0,0,0,2,1,1,81,81,81,81,0,1
425,436,11,12,0.5833333333,0.9166666667,1,11.5,0.9017857143,0.9375,0.3333333333,0.7767857143,11,12,11,12,1,0,0,0,2,1,1,105,112,105,112,7,1
631,648,18,19,0.8571428571,0.9047619048,1,18.5,0.8724832215,0.8926174497,0.7142857143,0.8187919463,21,20,20,21,1,0,0,0,2,1,1,149,137,137,149,12,1
546,557,12,12,0.5,0.9166666667,0,12,0.8571428571,0.9579831933,0.3333333333,0.781512605,12,12,12,12,0,0,0,0,2,1,1,119,114,114,119,5,1
183,208,26,26,0.6071428571,0.9642857143,0,26,0.9336283186,0.982300885,0.9642857143,0.982300885,28,28,28,28,0,0,0,0,2,1,1,226,225,225,226,1,1
506,524,19,19,1,1,0,19,1,1,1,1,20,20,20,20,0,0,0,0,2,1,1,235,235,235,235,0,1
570,590,21,21,1,1,0,21,1,1,1,1,23,23,23,23,0,0,0,0,2,1,1,166,166,166,166,0,1
253,269,17,17,1,1,0,17,1,1,1,1,19,19,19,19,0,0,0,0,2,1,1,185,185,185,185,0,1
125,198,74,89,0.7865168539,0.7865168539,15,81.5,0.8190184049,0.8190184049,0.7528089888,0.8144171779,89,74,74,89,15,0,0,0,2,1,1,652,536,536,652,116,1
96,136,41,48,0.8125,0.8125,7,44.5,0.8550185874,0.8624535316,0.2291666667,0.6728624535,48,41,41,48,7,0,0,0,2,1,1,269,232,232,269,37,1
394,404,11,15,0.4375,0.5,4,13,0.8034682081,0.8554913295,0.125,0.6589595376,16,12,12,16,4,0,0,0,2,1,1,173,159,159,173,14,1
99,111,13,13,1,1,0,13,1,1,1,1,13,13,13,13,0,0,0,0,2,1,1,117,117,117,117,0,1
565,585,18,21,0.7391304348,0.7826086957,3,19.5,0.7951807229,0.813253012,0.347826087,0.656626506,20,23,20,23,3,0,0,0,2,1,1,137,166,137,166,29,1
280,289,10,10,0.9090909091,0.9090909091,0,10,0.9847328244,0.9847328244,0.9090909091,0.9847328244,11,11,11,11,0,0,0,0,2,1,1,129,131,129,131,2,1
910,922,11,13,0.5384615385,0.8461538462,2,12,0.7933884298,0.867768595,0.3076923077,0.7107438017,11,13,11,13,2,0,0,0,2,1,1,105,121,105,121,16,1
1257,1267,11,11,1,1,0,11,1,1,1,1,12,12,12,12,0,0,0,0,2,1,1,81,81,81,81,0,1
202,265,64,64,1,1,0,64,1,1,1,1,64,64,64,64,0,0,0,0,2,1,1,511,511,511,511,0,1
1440,1458,19,19,1,1,0,19,1,1,1,1,19,19,19,19,0,0,0,0,2,1,1,166,166,166,166,0,1
524,546,23,23,0.88,1,0,23,0.9786096257,1,1,1,25,25,25,25,0,0,0,0,2,1,1,187,187,187,187,0,1
243,252,10,10,1,1,0,10,1,1,1,1,10,10,10,10,0,0,0,0,2,1,1,90,90,90,90,0,1
248,261,13,14,0.4285714286,0.8571428571,1,13.5,0.7482014388,0.8705035971,0.2857142857,0.7050359712,13,14,13,14,1,0,0,0,2,1,1,121,139,121,139,18,1
264,277,12,14,0.7142857143,0.7857142857,2,13,0.754491018,0.7664670659,0.5,0.7245508982,12,14,12,14,2,0,0,0,2,1,1,128,167,128,167,39,1
69,89,16,21,0.5238095238,0.7619047619,5,18.5,0.6418918919,0.7027027027,0.380952381,0.6216216216,16,21,16,21,5,0,0,0,2,1,1,104,148,104,148,44,1
766,775,10,10,1,1,0,10,1,1,1,1,10,10,10,10,0,0,0,0,2,1,1,51,51,51,51,0,1
910,922,12,13,0.5384615385,0.9230769231,1,12.5,0.8347107438,0.9256198347,0.3846153846,0.7685950413,12,13,12,13,1,0,0,0,2,1,1,112,121,112,121,9,1
1156,1170,15,15,0.6,0.9333333333,0,15,0.9147286822,0.9689922481,0.3333333333,0.8527131783,15,15,15,15,0,0,0,0,2,1,1,129,126,126,129,3,1
444,453,10,10,0.5833333333,0.8333333333,0,10,0.7674418605,0.8953488372,0.5,0.7906976744,12,12,12,12,0,0,0,0,2,1,1,86,82,82,86,4,1
353,376,24,24,1,1,0,24,1,1,1,1,24,24,24,24,0,0,0,0,2,1,1,344,344,344,344,0,1
772,786,15,15,1,1,0,15,1,1,1,1,15,15,15,15,0,2,2,4,2,1,1,163,163,163,163,0,1
349,396,48,48,1,1,0,48,1,1,1,1,48,48,48,48,0,0,0,0,2,1,1,336,336,336,336,0,1
43,52,10,10,1,1,0,10,1,1,1,1,10,10,10,10,0,0,0,0,2,1,1,88,88,88,88,0,1
629,646,18,23,0.68,0.72,5,20.5,0.7165775401,0.7326203209,0.32,0.5989304813,25,20,20,25,5,0,0,0,2,1,1,187,137,137,187,50,1
423,463,41,41,1,1,0,41,1,1,1,1,41,41,41,41,0,0,0,0,2,1,1,287,287,287,287,0,1
200,214,15,15,1,1,0,15,1,1,1,1,15,15,15,15,0,0,0,0,2,1,1,198,198,198,198,0,1
631,648,18,18,0.9,1,0,18,0.9854014599,1,1,1,20,20,20,20,0,0,0,0,2,1,1,137,137,137,137,0,1
546,570,25,25,0.8461538462,1,0,25,0.9759615385,1,1,1,26,26,26,26,0,1,1,2,4,2,2,208,208,208,208,0,1
126,138,13,13,1,1,0,13,1,1,1,1,13,13,13,13,0,0,0,0,2,1,1,111,111,111,111,0,1
493,507,15,15,1,1,0,15,1,1,1,1,16,16,16,16,0,0,0,0,2,1,1,173,173,173,173,0,1
44,73,30,30,1,1,0,30,1,1,1,1,30,30,30,30,0,0,0,0,2,1,1,214,214,214,214,0,1
546,568,23,23,0.88,1,0,23,0.9786096257,1,1,1,25,25,25,25,0,0,0,0,2,1,1,187,187,187,187,0,1
133,146,12,14,0.5,0.8571428571,2,13,0.7862068966,0.8206896552,0.5714285714,0.8,12,14,12,14,2,0,0,0,2,1,1,119,145,119,145,26,1
141,155,15,18,0.3333333333,0.7222222222,3,16.5,0.6033519553,0.7988826816,0.2222222222,0.4972067039,18,15,15,18,3,0,0,0,2,1,1,179,148,148,179,31,1
629,646,18,18,0.9,1,0,18,0.9854014599,1,1,1,20,20,20,20,0,0,0,0,2,1,1,137,137,137,137,0,1
43,72,30,30,1,1,0,30,1,1,1,1,31,31,31,31,0,1,1,2,2,1,1,230,230,230,230,0,1
204,217,14,14,1,1,0,14,1,1,1,1,15,15,15,15,0,0,0,0,2,1,1,123,123,123,123,0,1
729,737,9,11,0.6153846154,0.7692307692,2,10,0.7171717172,0.7474747475,0.3846153846,0.5757575758,13,11,11,13,2,0,0,0,2,1,1,99,75,75,99,24,1
316,324,9,9,0.6666666667,0.7777777778,0,9,0.9781021898,0.9854014599,0.7777777778,0.9854014599,9,9,9,9,0,0,0,0,2,1,1,137,137,137,137,0,1
648,665,18,21,0.7391304348,0.7826086957,3,19.5,0.7951807229,0.813253012,0.347826087,0.656626506,23,20,20,23,3,0,0,0,2,1,1,166,137,137,166,29,1
897,907,11,11,1,1,0,11,1,1,1,1,12,12,12,12,0,0,0,0,2,1,1,80,80,80,80,0,1
320,367,48,48,1,1,0,48,1,1,1,1,48,48,48,48,0,0,0,0,2,1,1,336,336,336,336,0,1
176,192,17,17,0.5263157895,0.9473684211,0,17,0.8736263736,0.956043956,0.9473684211,0.9505494505,19,19,19,19,0,0,1,1,2,1,1,176,182,176,182,6,1
1,204,204,204,1,1,0,204,1,1,1,1,185,185,185,185,0,0,0,0,0,0,0,1550,1550,1550,1550,0,1
336,365,30,30,1,1,0,30,1,1,1,1,30,30,30,30,0,0,0,0,2,1,1,210,210,210,210,0,1
353,383,31,31,1,1,0,31,1,1,1,1,31,31,31,31,0,0,0,0,2,1,1,290,290,290,290,0,1
397,420,24,24,1,1,0,24,1,1,1,1,24,24,24,24,0,0,0,0,2,1,1,168,168,168,168,0,1
184,198,15,15,1,1,0,15,1,1,1,1,15,15,15,15,0,0,0,0,2,1,1,198,198,198,198,0,1
474,484,11,11,0.9230769231,1,0,11,0.9894736842,1,1,1,13,13,13,13,0,0,0,0,2,1,1,95,95,95,95,0,1
548,572,25,25,0.8461538462,1,0,25,0.9759615385,1,1,1,26,26,26,26,0,1,1,2,4,2,2,208,208,208,208,0,1
433,442,10,10,0.4,1,0,10,0.9668508287,1,0.9,0.9944751381,10,10,10,10,0,0,0,0,2,1,1,181,181,181,181,0,1
555,586,32,32,1,1,0,32,1,1,1,1,32,32,32,32,0,0,0,0,2,1,1,224,224,224,224,0,1
659,682,24,24,1,1,0,24,1,1,1,1,25,25,25,25,0,0,0,0,2,1,1,186,186,186,186,0,1
425,434,10,10,0.8,1,0,10,0.9545454545,1,1,1,10,10,10,10,0,0,0,0,2,1,1,44,44,44,44,0,1
171,183,13,13,1,1,0,13,1,1,1,1,15,15,15,15,0,2,2,4,2,1,1,133,133,133,133,0,1
570,590,21,21,1,1,0,21,1,1,1,1,23,23,23,23,0,0,0,0,2,1,1,166,166,166,166,0,1
461,474,14,14,1,1,0,14,1,1,1,1,14,14,14,14,0,0,0,0,2,1,1,128,128,128,128,0,1
202,265,64,64,1,1,0,64,1,1,1,1,64,64,64,64,0,0,0,0,2,1,1,511,511,511,511,0,1
414,423,10,10,0.8,0.8,0,10,0.84,0.88,0.4,0.66,10,10,10,10,0,0,0,0,2,1,1,50,44,44,50,6,1
64,80,17,17,0.8421052632,1,0,17,0.9817073171,1,1,1,19,19,19,19,0,1,1,2,2,1,1,164,164,164,164,0,1
572,592,21,23,0.84,0.88,2,22,0.8395721925,0.871657754,0.68,0.807486631,25,23,23,25,2,0,0,0,2,1,1,187,166,166,187,21,1
67,80,13,14,0.8571428571,0.9285714286,1,13.5,0.9,0.9166666667,0.2857142857,0.7333333333,13,14,13,14,1,0,0,0,2,1,1,110,120,110,120,10,1
1156,1170,13,15,0.6,0.8,2,14,0.8650793651,0.9126984127,0.4666666667,0.8095238095,13,15,13,15,2,0,0,0,2,1,1,115,126,115,126,11,1
821,832,12,13,0.2307692308,0.3846153846,1,12.5,0.3409090909,0.5568181818,0.2307692308,0.3863636364,13,12,12,13,1,0,0,0,2,1,1,88,65,65,88,23,1
425,436,12,14,0.3571428571,0.7142857143,2,13,0.5688622754,0.6586826347,0.1428571429,0.4730538922,14,12,12,14,2,0,0,0,2,1,1,167,112,112,167,55,1
1246,1564,319,319,1,1,0,319,1,1,1,1,226,226,226,226,0,2,2,4,2,1,1,1644,1644,1644,1644,0,1
522,544,18,23,0.68,0.72,5,20.5,0.7165775401,0.7326203209,0.32,0.5989304813,20,25,20,25,5,0,0,0,2,1,1,137,187,137,187,50,1
194,203,10,10,1,1,0,10,1,1,1,1,8,8,8,8,0,0,0,0,2,1,1,59,59,59,59,0,1
92,103,12,19,0.55,0.55,7,15.5,0.7939393939,0.8,0.15,0.6424242424,20,14,14,20,6,0,0,0,2,1,1,165,133,133,165,32,1
507,516,10,10,0.8,0.9,0,10,0.94,0.98,0.9,0.98,10,10,10,10,0,0,0,0,2,1,1,50,50,50,50,0,1
572,592,21,23,0.84,0.88,2,22,0.8395721925,0.871657754,0.68,0.807486631,25,23,23,25,2,0,0,0,2,1,1,187,166,166,187,21,1
63,72,10,10,0.4,0.6,0,10,0.64,0.84,0.5,0.74,10,10,10,10,0,0,0,0,2,1,1,45,50,45,50,5,1
310,322,13,13,0.8461538462,0.8461538462,0,13,0.9897959184,0.9897959184,0.8461538462,0.9897959184,13,13,13,13,0,0,0,0,2,1,1,196,196,196,196,0,1
247,263,17,17,1,1,0,17,1,1,1,1,19,19,19,19,0,0,0,0,2,1,1,185,185,185,185,0,1
423,439,17,17,1,1,0,17,1,1,1,1,17,17,17,17,0,0,0,0,2,1,1,119,119,119,119,0,1
128,138,11,11,0.4545454545,0.7272727273,0,11,0.6944444444,0.8333333333,0.3636363636,0.6527777778,11,11,11,11,0,0,0,0,2,1,1,64,72,64,72,8,1
255,281,27,31,0.5806451613,0.6774193548,4,29,0.6711111111,0.7688888889,0.2258064516,0.56,31,27,27,31,4,0,0,0,2,1,1,225,187,187,225,38,1
208,241,34,34,1,1,0,34,1,1,1,1,35,35,35,35,0,0,0,0,2,1,1,387,387,387,387,0,1
604,617,14,14,1,1,0,14,1,1,1,1,15,15,15,15,0,0,0,0,2,1,1,131,131,131,131,0,1
335,349,15,15,1,1,0,15,1,1,1,1,15,15,15,15,0,0,0,0,2,1,1,117,117,117,117,0,1
376,407,32,32,1,1,0,32,1,1,1,1,32,32,32,32,0,0,0,0,2,1,1,224,224,224,224,0,1
1058,1080,20,23,0.4347826087,0.7826086957,3,21.5,0.7424242424,0.8257575758,0.2173913043,0.6477272727,20,23,20,23,3,0,0,0,2,1,1,221,264,221,264,43,1
440,452,13,14,0.7142857143,0.7857142857,1,13.5,0.8796992481,0.9172932331,0.5714285714,0.7969924812,14,13,13,14,1,0,0,0,2,1,1,128,133,128,133,5,1
172,188,17,17,0.7368421053,0.9473684211,0,17,0.9285714286,0.956043956,0.9473684211,0.9505494505,19,19,19,19,0,1,0,1,2,1,1,182,176,176,182,6,1
369,379,10,11,0.3636363636,0.5454545455,1,10.5,0.7757009346,0.8878504673,0.1818181818,0.6168224299,10,11,10,11,1,0,0,0,2,1,1,107,105,105,107,2,1
925,937,11,13,0.5384615385,0.8461538462,2,12,0.7933884298,0.867768595,0.3076923077,0.7107438017,11,13,11,13,2,0,0,0,2,1,1,105,121,105,121,16,1
497,516,20,20,0.9523809524,0.9523809524,0,20,0.9912280702,0.9912280702,0.9523809524,0.9912280702,21,21,21,21,0,0,0,0,2,1,1,114,114,114,114,0,1
30,44,15,17,0.4117647059,0.7058823529,2,16,0.5666666667,0.7222222222,0.4117647059,0.6222222222,17,15,15,17,2,0,0,0,2,1,1,90,72,72,90,18,1
322,360,39,39,0.9487179487,0.9487179487,0,39,0.9730639731,0.9730639731,0.8205128205,0.9562289562,39,39,39,39,0,0,0,0,2,1,1,297,296,296,297,1,1
120,136,17,17,0.7368421053,0.9473684211,0,17,0.9285714286,0.956043956,0.9473684211,0.9505494505,19,19,19,19,0,0,1,1,2,1,1,176,182,176,182,6,1
650,667,18,18,0.9,1,0,18,0.9854014599,1,1,1,20,20,20,20,0,0,0,0,2,1,1,137,137,137,137,0,1
291,309,19,19,0.8947368421,0.8947368421,0,19,0.963963964,0.963963964,0.8947368421,0.963963964,19,19,19,19,0,0,0,0,2,1,1,111,109,109,111,2,1
348,377,30,30,1,1,0,30,1,1,1,1,30,30,30,30,0,0,0,0,2,1,1,210,210,210,210,0,1
328,349,22,22,1,1,0,22,1,1,1,1,22,22,22,22,0,0,0,0,2,1,1,154,154,154,154,0,1
940,952,12,13,0.5384615385,0.9230769231,1,12.5,0.8347107438,0.9256198347,0.3846153846,0.7685950413,12,13,12,13,1,0,0,0,2,1,1,112,121,112,121,9,1
222,234,13,13,0.5833333333,0.8333333333,0,13,0.8194444444,0.8680555556,0.3333333333,0.5625,12,12,12,12,0,0,0,0,4,2,2,144,128,128,144,16,1
135,173,39,39,0.9487179487,1,0,39,0.9929328622,1,1,1,39,39,39,39,0,1,1,2,2,1,1,283,283,283,283,0,1
1006,1019,13,14,0.5714285714,0.9285714286,1,13.5,0.8916666667,0.9416666667,0.4285714286,0.825,13,14,13,14,1,0,0,0,2,1,1,113,120,113,120,7,1
126,138,13,13,1,1,0,13,1,1,1,1,13,13,13,13,0,0,0,0,2,1,1,111,111,111,111,0,1
648,667,20,20,0.8571428571,1,0,20,0.9806451613,1,1,1,21,21,21,21,0,1,1,2,4,2,2,155,155,155,155,0,1
1,68,68,68,1,1,0,68,1,1,1,1,47,47,47,47,0,0,0,0,0,0,0,325,325,325,325,0,1
725,744,20,20,0.9523809524,0.9523809524,0,20,0.9912280702,0.9912280702,0.9523809524,0.9912280702,21,21,21,21,0,0,0,0,2,1,1,114,114,114,114,0,1
110,197,88,88,1,1,0,88,1,1,1,1,88,88,88,88,0,0,0,0,2,1,1,484,484,484,484,0,1
353,387,35,35,0.9696969697,0.9696969697,0,35,0.9885583524,0.9908466819,0.9696969697,0.9908466819,33,33,33,33,0,0,0,0,4,2,2,434,437,434,437,3,1
352,392,41,41,1,1,0,41,1,1,1,1,41,41,41,41,0,0,0,0,2,1,1,287,287,287,287,0,1
558,609,52,53,0.7962962963,0.8333333333,1,52.5,0.8376865672,0.8843283582,0.1111111111,0.6399253731,54,53,53,54,1,0,0,0,2,1,1,502,536,502,536,34,1
200,214,12,15,0.8,0.8,3,13.5,0.8656716418,0.8656716418,0.7333333333,0.8507462687,12,15,12,15,3,0,0,0,2,1,1,58,67,58,67,9,1
247,263,17,17,1,1,0,17,1,1,1,1,19,19,19,19,0,0,0,0,2,1,1,185,185,185,185,0,1
517,539,21,23,0.84,0.88,2,22,0.8395721925,0.871657754,0.68,0.807486631,23,25,23,25,2,0,0,0,2,1,1,166,187,166,187,21,1
574,584,11,11,0.8181818182,1,0,11,0.984375,1,1,1,11,11,11,11,0,1,1,2,2,1,1,128,128,128,128,0,1
73,120,48,48,0.8125,0.9791666667,0,48,0.9346049046,0.9782016349,0.9791666667,0.9782016349,48,48,48,48,0,1,1,2,2,1,1,359,367,359,367,8,1
669,687,18,19,0.8571428571,0.9047619048,1,18.5,0.8724832215,0.8926174497,0.7142857143,0.8187919463,20,21,20,21,1,0,0,0,2,1,1,137,149,137,149,12,1
461,482,22,22,1,1,0,22,1,1,1,1,22,22,22,22,0,1,1,2,2,1,1,102,102,102,102,0,1
260,270,11,11,1,1,0,11,1,1,1,1,11,11,11,11,0,0,0,0,2,1,1,95,95,95,95,0,1
48,62,15,15,1,1,0,15,1,1,1,1,16,16,16,16,0,0,0,0,2,1,1,119,119,119,119,0,1
20,49,30,30,0.7096774194,0.9677419355,0,30,0.8859649123,0.9912280702,0.9677419355,0.9912280702,31,31,31,31,0,1,1,2,2,1,1,226,228,226,228,2,1
45,54,10,10,0.4,0.9,0,10,0.7727272727,0.9318181818,0.4,0.7954545455,10,10,10,10,0,0,0,0,2,1,1,44,42,42,44,2,1
99,111,13,13,1,1,0,13,1,1,1,1,13,13,13,13,0,0,0,0,2,1,1,117,117,117,117,0,1
992,1003,12,13,0.6153846154,0.9230769231,1,12.5,0.9026548673,0.9469026549,0.3846153846,0.8230088496,13,12,12,13,1,0,0,0,2,1,1,113,107,107,113,6,1
648,665,18,18,1,1,0,18,1,1,1,1,20,20,20,20,0,0,0,0,2,1,1,137,137,137,137,0,1
4,11,8,8,0.625,1,0,8,0.875,1,0.5,0.8928571429,8,8,8,8,0,0,0,0,0,0,0,56,56,56,56,0,0
311,323,13,13,1,1,0,13,1,1,1,1,13,13,13,13,0,0,0,0,2,1,1,133,133,133,133,0,1
251,264,14,14,0.3333333333,0.9333333333,0,14,0.8451612903,0.9548387097,0.7333333333,0.935483871,15,15,15,15,0,0,0,0,2,1,1,155,155,155,155,0,1
440,452,13,14,0.7142857143,0.7857142857,1,13.5,0.8796992481,0.9172932331,0.5714285714,0.7969924812,14,13,13,14,1,0,0,0,2,1,1,128,133,128,133,5,1
320,332,13,13,0.1538461538,0.9230769231,0,13,0.7697841727,0.9568345324,0.9230769231,0.9352517986,13,13,13,13,0,1,1,2,2,1,1,139,133,133,139,6,0
126,138,13,13,1,1,0,13,1,1,1,1,13,13,13,13,0,0,0,0,2,1,1,111,111,111,111,0,1
120,144,25,25,0.5357142857,0.8928571429,0,25,0.8507462687,0.9104477612,0.4642857143,0.7089552239,28,28,28,28,0,1,1,2,2,1,1,244,268,244,268,24,1
206,217,12,14,0.5,0.8571428571,2,13,0.7793103448,0.8137931034,0.5,0.7931034483,14,12,12,14,2,0,0,0,2,1,1,145,118,118,145,27,1
73,82,10,10,1,1,0,10,1,1,1,1,10,10,10,10,0,0,0,0,2,1,1,62,62,62,62,0,1
552,573,22,22,1,1,0,22,1,1,1,1,22,22,22,22,0,0,0,0,2,1,1,154,154,154,154,0,1
159,173,15,15,1,1,0,15,1,1,1,1,15,15,15,15,0,0,0,0,2,1,1,190,190,190,190,0,1
76,100,25,25,0.75,1,0,25,0.9711934156,1,1,1,28,28,28,28,0,1,1,2,2,1,1,243,243,243,243,0,1
235,243,9,9,0.6363636364,0.7272727273,0,9,0.8461538462,0.8974358974,0.7272727273,0.8974358974,11,11,11,11,0,0,0,0,2,1,1,74,78,74,78,4,1
1140,1175,36,36,0.6857142857,0.7142857143,0,36,0.7006802721,0.7619047619,0.3428571429,0.5612244898,35,33,33,35,2,0,0,0,2,1,1,294,262,262,294,32,1
248,261,14,14,1,1,0,14,1,1,1,1,14,14,14,14,0,0,0,0,2,1,1,139,139,139,139,0,1
353,374,22,22,1,1,0,22,1,1,1,1,22,22,22,22,0,0,0,0,2,1,1,287,287,287,287,0,1
177,189,13,13,1,1,0,13,1,1,1,1,13,13,13,13,0,1,1,2,2,1,1,121,121,121,121,0,1
708,717,10,10,0.3,0.9,0,10,0.8271604938,0.987654321,0.9,0.987654321,10,10,10,10,0,0,0,0,2,1,1,81,80,80,81,1,1
708,744,37,39,0.8055555556,0.9444444444,2,38,0.94,0.968,0.6666666667,0.896,36,34,34,36,2,0,0,0,2,1,1,250,242,242,250,8,1
406,441,36,36,1,1,0,36,1,1,1,1,38,38,38,38,0,0,0,0,2,1,1,349,349,349,349,0,1
160,180,20,21,0.6666666667,0.8571428571,1,20.5,0.8275862069,0.8896551724,0.4285714286,0.7517241379,20,21,20,21,1,0,0,0,2,1,1,145,137,137,145,8,1
206,217,12,14,0.5714285714,0.8571428571,2,13,0.8201438849,0.8489208633,0.2857142857,0.7122302158,14,12,12,14,2,0,0,0,2,1,1,139,118,118,139,21,1
6,18,13,13,1,1,0,13,1,1,1,1,13,13,13,13,0,0,0,0,2,1,1,138,138,138,138,0,1
783,795,13,13,0.9285714286,1,0,13,0.9913793103,1,1,1,14,14,14,14,0,1,1,2,2,1,1,116,116,116,116,0,1
268,293,26,26,1,1,0,26,1,1,1,1,26,26,26,26,0,0,0,0,2,1,1,337,337,337,337,0,1
61,97,37,37,1,1,0,37,1,1,1,1,37,37,37,37,0,0,0,0,2,1,1,276,276,276,276,0,1
335,349,15,15,1,1,0,15,1,1,1,1,15,15,15,15,0,0,0,0,2,1,1,117,117,117,117,0,1
311,323,13,14,0.7142857143,0.7857142857,1,13.5,0.8796992481,0.9172932331,0.5714285714,0.7969924812,14,13,13,14,1,0,0,0,2,1,1,128,133,128,133,5,1
335,349,15,15,1,1,0,15,1,1,1,1,15,15,15,15,0,0,0,0,2,1,1,117,117,117,117,0,1
195,255,61,64,0.9090909091,0.9090909091,3,62.5,0.9601226994,0.963190184,0.6515151515,0.9018404908,66,63,63,66,3,0,0,0,2,1,1,652,634,634,652,18,1
73,85,13,13,1,1,0,13,1,1,1,1,14,14,14,14,0,0,0,0,2,1,1,160,160,160,160,0,1
687,703,17,17,1,1,0,17,1,1,1,1,17,17,17,17,0,0,0,0,2,1,1,84,84,84,84,0,1
126,141,16,16,1,1,0,16,1,1,1,1,16,16,16,16,0,0,0,0,2,1,1,126,126,126,126,0,1
878,891,14,14,1,1,0,14,1,1,1,1,14,14,14,14,0,0,0,0,2,1,1,129,129,129,129,0,1
408,422,15,16,0.375,0.875,1,15.5,0.8711656442,0.9386503067,0.25,0.7668711656,16,15,15,16,1,0,0,0,2,1,1,163,153,153,163,10,1
299,311,13,13,0.9230769231,0.9230769231,0,13,0.9866666667,0.9866666667,0.9230769231,0.9866666667,13,13,13,13,0,0,0,0,2,1,1,75,74,74,75,1,1
265,286,22,22,1,1,0,22,1,1,1,1,22,22,22,22,0,3,3,6,2,1,1,142,142,142,142,0,1
546,568,21,23,0.84,0.88,2,22,0.8395721925,0.871657754,0.68,0.807486631,23,25,23,25,2,0,0,0,2,1,1,166,187,166,187,21,1
222,254,33,33,1,1,0,33,1,1,1,1,34,34,34,34,0,0,0,0,2,1,1,261,261,261,261,0,1
287,325,39,39,0.8974358974,0.8974358974,0,39,0.9506578947,0.9506578947,0.4615384615,0.7105263158,39,39,39,39,0,0,0,0,2,1,1,304,297,297,304,7,1
204,223,20,20,1,1,0,20,1,1,1,1,38,38,38,38,0,0,0,0,2,1,1,316,316,316,316,0,1
383,410,28,28,1,1,0,28,1,1,1,1,29,29,29,29,0,1,1,2,2,1,1,268,268,268,268,0,1
206,221,15,16,0.5625,0.6875,1,15.5,0.7387387387,0.8108108108,0.1875,0.5945945946,15,16,15,16,1,0,0,0,2,1,1,111,106,106,111,5,1
369,379,11,11,0.6363636364,1,0,11,0.9619047619,1,1,1,11,11,11,11,0,0,0,0,2,1,1,105,105,105,105,0,1
104,126,23,23,1,1,0,23,1,1,1,1,23,23,23,23,0,0,0,0,2,1,1,177,177,177,177,0,1
1512,1529,17,18,0.5,0.8333333333,1,17.5,0.8724832215,0.9530201342,0.2777777778,0.8053691275,17,18,17,18,1,0,0,0,2,1,1,149,148,148,149,1,1
1,68,68,68,1,1,0,68,1,1,1,1,47,47,47,47,0,0,0,0,0,0,0,325,325,325,325,0,1
79,140,62,62,1,1,0,62,1,1,1,1,62,62,62,62,0,1,1,2,2,1,1,443,443,443,443,0,1
493,507,15,15,1,1,0,15,1,1,1,1,16,16,16,16,0,0,0,0,2,1,1,173,173,173,173,0,1
754,780,27,27,1,1,0,27,1,1,1,1,27,27,27,27,0,0,0,0,2,1,1,193,193,193,193,0,1
347,376,30,30,1,1,0,30,1,1,1,1,30,30,30,30,0,0,0,0,2,1,1,210,210,210,210,0,1
108,123,16,17,0.6470588235,0.7058823529,1,16.5,0.7565789474,0.8157894737,0.3529411765,0.6710526316,17,16,16,17,1,0,0,0,2,1,1,152,132,132,152,20,1
414,433,20,20,1,1,0,20,1,1,1,1,21,21,21,21,0,0,0,0,2,1,1,189,189,189,189,0,1
293,304,12,12,1,1,0,12,1,1,1,1,14,14,14,14,0,0,0,0,2,1,1,91,91,91,91,0,1
99,111,13,13,1,1,0,13,1,1,1,1,13,13,13,13,0,0,0,0,2,1,1,117,117,117,117,0,1
232,245,14,14,1,1,0,14,1,1,1,1,14,14,14,14,0,0,0,0,2,1,1,107,107,107,107,0,1
106,123,15,18,0.2777777778,0.3333333333,3,16.5,0.4,0.6260869565,0.2777777778,0.4608695652,15,18,15,18,3,0,0,0,2,1,1,108,115,108,115,7,0
10,10,1,36,0.0357142857,0.0357142857,35,18.5,0.9316466933,0.9316466933,0.0357142857,0.9316466933,28,1,1,28,27,1,0,1,0,0,0,2253,2099,2099,2253,154,0
185,196,12,12,0.5833333333,0.75,0,12,0.8,0.8416666667,0.6666666667,0.8333333333,12,12,12,12,0,0,0,0,2,1,1,104,120,104,120,16,1
276,291,16,16,0.375,1,0,16,0.9239766082,1,1,1,16,16,16,16,0,0,0,0,2,1,1,171,171,171,171,0,1
369,379,11,12,0.5833333333,0.9166666667,1,11.5,0.9017857143,0.9375,0.3333333333,0.7767857143,12,11,11,12,1,0,0,0,2,1,1,112,105,105,112,7,1
822,829,8,8,0.8888888889,0.8888888889,0,8,0.8330550918,0.9131886477,0.8888888889,0.9131886477,9,9,9,9,0,0,0,0,2,1,1,547,599,547,599,52,1
92,105,14,14,1,1,0,14,1,1,1,1,14,14,14,14,0,0,0,0,2,1,1,91,91,91,91,0,1
472,490,19,19,1,1,0,19,1,1,1,1,19,19,19,19,0,0,0,0,2,1,1,92,92,92,92,0,1
135,182,48,54,0.8148148148,0.8888888889,6,51,0.8988439306,0.9190751445,0.8148148148,0.8988439306,54,48,48,54,6,0,0,0,2,1,1,346,318,318,346,28,1
522,540,19,19,1,1,0,19,1,1,1,1,20,20,20,20,0,0,0,0,2,1,1,235,235,235,235,0,1
629,646,18,19,0.8571428571,0.9047619048,1,18.5,0.8724832215,0.8926174497,0.7142857143,0.8187919463,21,20,20,21,1,0,0,0,2,1,1,149,137,137,149,12,1
17,140,115,124,0.8790322581,0.8870967742,9,119.5,0.888337469,0.9214226634,0.8629032258,0.9164598842,115,124,115,124,9,0,0,0,2,1,1,1118,1209,1118,1209,91,1
1386,1394,9,9,0.2727272727,0.7272727273,0,9,0.5465116279,0.7558139535,0.2727272727,0.5697674419,11,11,11,11,0,0,0,0,2,1,1,78,86,78,86,8,1
113,124,12,12,1,1,0,12,1,1,1,1,12,12,12,12,0,0,0,0,2,1,1,67,67,67,67,0,1
481,495,15,15,1,1,0,15,1,1,1,1,15,15,15,15,0,0,0,0,2,1,1,95,95,95,95,0,1
484,497,14,14,0.6428571429,0.7142857143,0,14,0.5555555556,0.6349206349,0.2857142857,0.4365079365,14,14,14,14,0,0,0,0,2,1,1,126,83,83,126,43,1
808,838,31,31,1,1,0,31,1,1,1,1,32,32,32,32,0,0,0,0,2,1,1,243,243,243,243,0,1
237,251,15,15,1,1,0,15,1,1,1,1,15,15,15,15,0,0,0,0,2,1,1,154,154,154,154,0,1
658,677,20,20,0.9523809524,0.9523809524,0,20,0.9912280702,0.9912280702,0.9523809524,0.9912280702,21,21,21,21,0,0,0,0,2,1,1,114,114,114,114,0,1
943,974,32,32,1,1,0,32,1,1,1,1,33,33,33,33,0,0,0,0,2,1,1,293,293,293,293,0,1
132,155,24,24,0.625,0.9166666667,0,24,0.92039801,0.9900497512,0.75,0.9651741294,24,24,24,24,0,0,0,0,2,1,1,201,201,201,201,0,1
572,582,11,11,0.7272727273,1,0,11,0.953125,1,1,1,11,11,11,11,0,1,1,2,2,1,1,128,128,128,128,0,1
309,347,39,39,0.9487179487,0.9487179487,0,39,0.9736842105,0.9736842105,0.4871794872,0.7302631579,39,39,39,39,0,0,0,0,2,1,1,296,304,296,304,8,1
81,86,6,6,1,1,0,6,1,1,1,1,6,6,6,6,0,0,0,0,2,1,1,73,73,73,73,0,1
1548,1565,16,18,0.6666666667,0.8333333333,2,17,0.8402777778,0.9097222222,0.6111111111,0.8611111111,16,18,16,18,2,0,0,0,2,1,1,131,144,131,144,13,1
126,138,13,13,1,1,0,13,1,1,1,1,13,13,13,13,0,0,0,0,2,1,1,111,111,111,111,0,1
328,347,20,20,1,1,0,20,1,1,1,1,23,23,23,23,0,0,0,0,2,1,1,269,269,269,269,0,1
564,576,13,13,1,1,0,13,1,1,1,1,13,13,13,13,0,0,0,0,2,1,1,154,154,154,154,0,1
231,243,13,13,0.8571428571,1,0,13,0.9702970297,1,1,1,14,14,14,14,0,0,0,0,2,1,1,101,101,101,101,0,1
54,98,45,45,1,1,0,45,1,1,1,1,23,23,23,23,0,0,0,0,0,0,0,198,198,198,198,0,0
87,130,44,44,1,1,0,44,1,1,1,1,12,12,12,12,0,1,1,2,0,0,0,98,98,98,98,0,1
629,646,18,18,1,1,0,18,1,1,1,1,20,20,20,20,0,0,0,0,2,1,1,137,137,137,137,0,1
282,291,10,10,1,1,0,10,1,1,1,1,10,10,10,10,0,0,0,0,2,1,1,45,45,45,45,0,1
61,97,37,37,1,1,0,37,1,1,1,1,37,37,37,37,0,0,0,0,2,1,1,138,138,138,138,0,1
105,116,12,12,1,1,0,12,1,1,1,1,12,12,12,12,0,0,0,0,2,1,1,106,106,106,106,0,1
142,195,54,54,1,1,0,54,1,1,1,1,54,54,54,54,0,0,0,0,2,1,1,346,346,346,346,0,1
346,549,204,204,1,1,0,204,1,1,1,1,197,197,197,197,0,1,1,2,4,2,2,1834,1834,1834,1834,0,0
629,646,18,19,0.8571428571,0.9047619048,1,18.5,0.8724832215,0.8926174497,0.7142857143,0.8187919463,21,20,20,21,1,0,0,0,2,1,1,149,137,137,149,12,1
110,197,88,88,1,1,0,88,1,1,1,1,88,88,88,88,0,0,0,0,2,1,1,484,484,484,484,0,1
33,42,10,10,1,1,0,10,1,1,1,1,12,12,12,12,0,0,0,0,2,1,1,79,79,79,79,0,1
522,546,25,25,0.8461538462,1,0,25,0.9759615385,1,1,1,26,26,26,26,0,1,1,2,4,2,2,208,208,208,208,0,1
688,705,17,18,0.3333333333,0.8888888889,1,17.5,0.7709497207,0.9608938547,0.3888888889,0.8659217877,17,18,17,18,1,0,0,0,2,1,1,178,179,178,179,1,1
717,733,17,17,1,1,0,17,1,1,1,1,17,17,17,17,0,0,0,0,2,1,1,100,100,100,100,0,1
159,173,15,15,1,1,0,15,1,1,1,1,15,15,15,15,0,0,0,0,2,1,1,190,190,190,190,0,1
574,584,11,11,0.8181818182,1,0,11,0.984375,1,1,1,11,11,11,11,0,1,1,2,2,1,1,128,128,128,128,0,1
555,571,15,17,0.3529411765,0.8823529412,2,16,0.8258426966,0.9213483146,0.6470588235,0.8876404494,15,17,15,17,2,0,0,0,2,1,1,164,178,164,178,14,1
260,275,16,16,0.4,0.9333333333,0,16,0.7987804878,0.9268292683,0.4,0.7926829268,15,15,15,15,0,0,0,0,4,2,2,153,164,153,164,11,1
424,447,22,24,0.125,0.2916666667,2,23,0.3636363636,0.6060606061,0.125,0.4242424242,22,24,22,24,2,2,0,2,2,1,1,159,165,159,165,6,0
261,307,47,47,1,1,0,47,1,1,1,1,50,50,50,50,0,0,0,0,2,1,1,371,371,371,371,0,1
11,22,12,16,0.7058823529,0.7058823529,4,14,0.9708029197,0.9708029197,0.7058823529,0.9708029197,17,14,14,17,3,0,0,0,2,1,1,137,133,133,137,4,1
248,281,34,34,0,1,0,34,0.8181818182,1,0.0294117647,0.8315508021,34,34,34,34,0,0,0,0,2,1,1,374,374,374,374,0,0
37,120,73,84,0.7261904762,0.7261904762,11,78.5,0.7945425361,0.8138041734,0.4047619048,0.6548956661,73,84,73,84,11,0,0,0,2,1,1,507,623,507,623,116,1
530,541,12,12,1,1,0,12,1,1,1,1,13,13,13,13,0,0,0,0,2,1,1,104,104,104,104,0,1
171,214,44,44,0.9545454545,0.9545454545,0,44,0.9304347826,0.9507246377,0.4545454545,0.7739130435,44,44,44,44,0,0,0,0,4,2,2,331,345,331,345,14,0
465,474,9,10,0.5,0.9,1,9.5,0.8684210526,0.9473684211,0.9,0.9473684211,9,10,9,10,1,0,0,0,2,1,1,72,76,72,76,4,1
815,824,10,11,0.7692307692,0.7692307692,1,10.5,0.8181818182,0.8484848485,0.3846153846,0.6363636364,13,12,12,13,1,0,0,0,2,1,1,99,86,86,99,13,1
111,143,26,33,0.2424242424,0.3939393939,7,29.5,0.3838862559,0.5639810427,0.2424242424,0.4454976303,26,33,26,33,7,0,0,0,2,1,1,166,211,166,211,45,0
154,168,15,15,0.7647058824,1,0,15,0.974522293,1,1,1,17,17,17,17,0,0,0,0,2,1,1,157,157,157,157,0,0
159,162,4,7,0,0,3,5.5,0.3174603175,0.5873015873,0,0.380952381,7,4,4,7,3,2,0,2,2,1,1,63,55,55,63,8,0
667,685,19,19,1,1,0,19,1,1,1,1,21,21,21,21,0,0,0,0,2,1,1,149,149,149,149,0,1
328,336,9,9,0.8888888889,0.8888888889,0,9,0.9444444444,0.9444444444,0.8888888889,0.9444444444,9,9,9,9,0,2,2,4,2,1,1,85,90,85,90,5,1
174,186,12,13,0.1428571429,0.1428571429,1,12.5,0.3790322581,0.6209677419,0.1428571429,0.4193548387,13,14,13,14,1,0,0,0,2,1,1,124,118,118,124,6,0
834,851,17,18,0.7777777778,0.9444444444,1,17.5,0.8992248062,0.9224806202,0.3333333333,0.7209302326,17,18,17,18,1,0,0,0,2,1,1,119,129,119,129,10,1
127,138,12,12,0.9166666667,1,0,12,0.9913793103,1,1,1,12,12,12,12,0,0,0,0,2,1,1,116,116,116,116,0,1
15,32,11,18,0,0.1,7,14.5,0.3493975904,0.5542168675,0,0.3734939759,10,10,10,10,0,1,2,3,3,2,1,65,83,65,83,18,0
270,277,8,8,0.8888888889,1,0,8,0.9848484848,1,1,1,9,9,9,9,0,3,3,6,2,1,1,66,66,66,66,0,0
110,260,151,151,1,1,0,151,1,1,1,1,142,142,142,142,0,1,1,2,4,2,2,1042,1042,1042,1042,0,0
79,84,6,7,0.2857142857,0.7142857143,1,6.5,0.8068181818,0.9090909091,0.2857142857,0.7840909091,7,6,6,7,1,0,0,0,2,1,1,88,84,84,88,4,0
61,74,11,14,0.1666666667,0.25,3,12.5,0.4285714286,0.6071428571,0.1666666667,0.4880952381,10,12,10,12,2,0,2,2,4,2,2,77,84,77,84,7,0
328,338,11,11,1,1,0,11,1,1,1,1,11,11,11,11,0,0,0,0,2,1,1,87,87,87,87,0,1
26,31,6,8,0.25,0.5,2,7,0.8260869565,0.8550724638,0.5,0.8260869565,8,6,6,8,2,0,0,0,2,1,1,69,60,60,69,9,1
52,61,10,10,0.3,1,0,10,0.9326923077,1,1,1,10,10,10,10,0,0,0,0,2,1,1,104,104,104,104,0,1
43,55,9,13,0.2307692308,0.5384615385,4,11,0.7090909091,0.8181818182,0.5384615385,0.8181818182,9,13,9,13,4,1,1,2,2,1,1,45,55,45,55,10,0
882,894,13,13,1,1,0,13,1,1,1,1,16,16,16,16,0,0,0,0,2,1,1,127,127,127,127,0,1
202,265,64,64,1,1,0,64,1,1,1,1,64,64,64,64,0,0,0,0,2,1,1,511,511,511,511,0,1
346,377,31,32,0.96875,0.96875,1,31.5,0.9874371859,0.9874371859,0.4375,0.743718593,31,32,31,32,1,0,0,0,2,1,1,393,398,393,398,5,1
941,968,15,28,0.1428571429,0.1428571429,13,21.5,0.2146341463,0.3414634146,0.1428571429,0.2487804878,15,28,15,28,13,0,0,0,2,1,1,89,205,89,205,116,0
285,296,12,13,0.8461538462,0.8461538462,1,12.5,0.9252336449,0.9252336449,0.4615384615,0.8598130841,13,12,12,13,1,0,0,0,2,1,1,107,102,102,107,5,1
331,341,11,11,1,1,0,11,1,1,1,1,12,12,12,12,0,0,0,0,2,1,1,68,68,68,68,0,1
269,283,15,15,1,1,0,15,1,1,1,1,15,15,15,15,0,0,0,0,2,1,1,168,168,168,168,0,1
595,621,27,27,1,1,0,27,1,1,1,1,27,27,27,27,0,0,0,0,2,1,1,158,158,158,158,0,1
629,646,18,19,0.8571428571,0.9047619048,1,18.5,0.8724832215,0.8926174497,0.7142857143,0.8187919463,21,20,20,21,1,0,0,0,2,1,1,149,137,137,149,12,1
610,618,9,9,0.6,1,0,9,0.8732394366,1,1,1,10,10,10,10,0,0,0,0,2,1,1,71,71,71,71,0,1
29,83,55,55,1,1,0,55,1,1,1,1,55,55,55,55,0,0,0,0,2,1,1,552,552,552,552,0,1
293,304,12,13,0.7333333333,0.7333333333,1,12.5,0.7520661157,0.7520661157,0.3333333333,0.6115702479,15,14,14,15,1,0,0,0,2,1,1,121,91,91,121,30,1
224,241,11,18,0.1666666667,0.1666666667,7,14.5,0.3534482759,0.5344827586,0.1666666667,0.3879310345,11,18,11,18,7,0,0,0,2,1,1,87,116,87,116,29,0
406,441,36,36,1,1,0,36,1,1,1,1,38,38,38,38,0,0,0,0,2,1,1,349,349,349,349,0,1
1166,1199,34,34,1,1,0,34,1,1,1,1,36,36,36,36,0,0,0,0,2,1,1,257,257,257,257,0,1
399,427,29,46,0.4565217391,0.4782608696,17,37.5,0.9243697479,0.9299719888,0.4782608696,0.9271708683,46,33,33,46,13,0,0,0,2,1,1,351,357,351,357,6,1
425,436,11,12,0.5833333333,0.9166666667,1,11.5,0.9017857143,0.9375,0.3333333333,0.7767857143,11,12,11,12,1,0,0,0,2,1,1,105,112,105,112,7,1
70,79,10,11,0.25,0.4166666667,1,10.5,0.4305555556,0.6111111111,0.25,0.4861111111,12,11,11,12,1,0,0,0,2,1,1,68,72,68,72,4,0
144,162,19,23,0.2173913043,0.3043478261,4,21,0.4326923077,0.5673076923,0.2608695652,0.4423076923,23,19,19,23,4,0,0,0,2,1,1,104,91,91,104,13,0
31,223,193,193,1,1,0,193,1,1,1,1,188,188,188,188,0,1,1,2,4,2,2,1526,1526,1526,1526,0,0
478,489,12,12,1,1,0,12,1,1,1,1,13,13,13,13,0,0,0,0,2,1,1,104,104,104,104,0,1
94,114,21,23,0.7083333333,0.7083333333,2,22,0.7838827839,0.8021978022,0.5,0.7252747253,24,22,22,24,2,0,0,0,2,1,1,273,228,228,273,45,1
455,476,22,22,0,0,0,22,0.4444444444,0.6666666667,0,0.6666666667,22,22,22,22,0,0,0,0,2,1,1,198,154,154,198,44,0
89,106,18,25,1,1,7,21.5,1,1,1,1,13,13,13,13,0,2,2,4,0,0,0,80,80,80,80,0,0
69,84,16,19,0.1578947368,0.1578947368,3,17.5,0.464,0.64,0.1578947368,0.464,19,17,17,19,2,0,0,0,2,1,1,109,125,109,125,16,0
522,544,23,23,0.88,1,0,23,0.9786096257,1,1,1,25,25,25,25,0,0,0,0,2,1,1,187,187,187,187,0,1
382,392,11,11,0.6363636364,1,0,11,0.9619047619,1,1,1,11,11,11,11,0,0,0,0,2,1,1,105,105,105,105,0,0
292,333,42,53,0.5090909091,0.5818181818,11,47.5,0.8553345389,0.8933092224,0.0727272727,0.6130198915,55,44,44,55,11,0,0,0,2,1,1,553,544,544,553,9,1
450,460,11,11,1,1,0,11,1,1,1,1,12,12,12,12,0,0,0,0,2,1,1,76,76,76,76,0,1
126,138,13,13,1,1,0,13,1,1,1,1,13,13,13,13,0,0,0,0,2,1,1,111,111,111,111,0,1
130,139,10,10,0.5,0.7,0,10,0.5576923077,0.6538461538,0.6,0.6346153846,10,10,10,10,0,0,0,0,2,1,1,47,52,47,52,5,1
346,377,32,32,1,1,0,32,1,1,1,1,32,32,32,32,0,0,0,0,2,1,1,398,398,398,398,0,1
126,138,13,13,1,1,0,13,1,1,1,1,13,13,13,13,0,0,0,0,2,1,1,111,111,111,111,0,1
907,922,16,16,1,1,0,16,1,1,1,1,17,17,17,17,0,0,0,0,2,1,1,137,137,137,137,0,1
992,1003,12,12,1,1,0,12,1,1,1,1,12,12,12,12,0,0,0,0,2,1,1,107,107,107,107,0,1
1469,1480,12,12,1,1,0,12,1,1,1,1,12,12,12,12,0,0,0,0,2,1,1,90,90,90,90,0,0
629,646,18,23,0.68,0.72,5,20.5,0.7165775401,0.7326203209,0.32,0.5989304813,25,20,20,25,5,0,0,0,2,1,1,187,137,137,187,50,1
43,52,10,10,1,1,0,10,1,1,1,1,10,10,10,10,0,0,0,0,2,1,1,88,88,88,88,0,1
650,667,18,18,1,1,0,18,1,1,1,1,20,20,20,20,0,0,0,0,2,1,1,137,137,137,137,0,1
95,109,15,15,0.6666666667,0.7333333333,0,15,0.5802469136,0.6790123457,0.4666666667,0.5679012346,15,15,15,15,0,0,0,0,2,1,1,72,81,72,81,9,0
24,41,15,18,0.6666666667,0.7777777778,3,16.5,0.7409326425,0.7512953368,0.1666666667,0.5077720207,15,18,15,18,3,0,0,0,2,1,1,155,193,155,193,38,1
71,110,40,40,0.8,0.8,0,40,0.675,0.7,0.425,0.5325,40,40,40,40,0,0,0,0,2,1,1,280,400,280,400,120,1
570,590,21,23,0.84,0.88,2,22,0.8395721925,0.871657754,0.68,0.807486631,25,23,23,25,2,0,0,0,2,1,1,187,166,166,187,21,1
1162,1176,15,15,1,1,0,15,1,1,1,1,16,16,16,16,0,1,1,2,2,1,1,190,190,190,190,0,1
113,124,12,12,1,1,0,12,1,1,1,1,12,12,12,12,0,0,0,0,2,1,1,67,67,67,67,0,1
394,404,11,11,1,1,0,11,1,1,1,1,12,12,12,12,0,0,0,0,2,1,1,159,159,159,159,0,1
172,235,64,81,0.9189189189,0.9459459459,17,72.5,0.9752066116,0.979338843,0.6756756757,0.8842975207,36,37,36,37,1,0,0,0,4,2,2,242,242,242,242,0,1
190,212,23,23,1,1,0,23,1,1,1,1,25,25,25,25,0,0,0,0,2,1,1,202,202,202,202,0,1
73,83,11,13,0.1538461538,0.1538461538,2,12,0.3731343284,0.5223880597,0.1538461538,0.447761194,13,11,11,13,2,0,0,0,2,1,1,67,56,56,67,11,0
604,617,14,14,1,1,0,14,1,1,1,1,15,15,15,15,0,0,0,0,2,1,1,131,131,131,131,0,1
522,544,19,23,0.68,0.72,4,21,0.7326203209,0.7754010695,0.32,0.6256684492,21,25,21,25,4,0,0,0,2,1,1,149,187,149,187,38,1
52,106,55,55,1,1,0,55,1,1,1,1,28,28,28,28,0,1,1,2,0,0,0,241,241,241,241,0,0
179,199,21,22,0.7727272727,0.9545454545,1,21.5,0.9210526316,0.9526315789,0.9545454545,0.9526315789,22,21,21,22,1,0,0,0,2,1,1,190,181,181,190,9,1
73,82,10,10,1,1,0,10,1,1,1,1,10,10,10,10,0,0,0,0,2,1,1,62,62,62,62,0,1
570,590,21,21,1,1,0,21,1,1,1,1,23,23,23,23,0,0,0,0,2,1,1,166,166,166,166,0,1
667,685,18,19,0.8571428571,0.9047619048,1,18.5,0.8724832215,0.8926174497,0.7142857143,0.8187919463,20,21,20,21,1,0,0,0,2,1,1,137,149,137,149,12,1
689,700,12,12,0.8333333333,0.8333333333,0,12,0.9166666667,0.9351851852,0.25,0.7037037037,12,12,12,12,0,0,0,0,2,1,1,108,103,103,108,5,1
31,46,16,16,1,1,0,16,1,1,1,1,16,16,16,16,0,0,0,0,2,1,1,159,159,159,159,0,1
295,307,12,13,0.7333333333,0.7333333333,1,12.5,0.7520661157,0.7520661157,0.3333333333,0.6115702479,14,15,14,15,1,0,0,0,2,1,1,91,121,91,121,30,1
483,496,11,14,0.6875,0.75,3,12.5,0.871559633,0.880733945,0.3125,0.6605504587,13,16,13,16,3,0,0,0,2,1,1,99,109,99,109,10,1
445,454,10,10,0.8,1,0,10,0.96,1,1,1,10,10,10,10,0,0,0,0,2,1,1,50,50,50,50,0,1
648,665,18,23,0.68,0.72,5,20.5,0.7165775401,0.7326203209,0.32,0.5989304813,25,20,20,25,5,0,0,0,2,1,1,187,137,137,187,50,1
99,111,13,13,1,1,0,13,1,1,1,1,13,13,13,13,0,0,0,0,2,1,1,117,117,117,117,0,1
493,504,12,14,0.4285714286,0.8571428571,2,13,0.768707483,0.8095238095,0.8571428571,0.8095238095,14,12,12,14,2,0,0,0,2,1,1,147,119,119,147,28,1
183,197,15,15,1,1,0,15,1,1,1,1,16,16,16,16,0,0,0,0,2,1,1,119,119,119,119,0,1
771,797,27,27,1,1,0,27,1,1,1,1,27,27,27,27,0,0,0,0,2,1,1,232,232,232,232,0,1
149,157,9,9,1,1,0,9,1,1,1,1,11,11,11,11,0,0,0,0,2,1,1,105,105,105,105,0,1
85,96,12,12,0.4166666667,0.6666666667,0,12,0.5217391304,0.7391304348,0.5833333333,0.7246376812,12,12,12,12,0,0,0,0,2,1,1,69,60,60,69,9,0
43,52,10,10,1,1,0,10,1,1,1,1,10,10,10,10,0,0,0,0,2,1,1,88,88,88,88,0,1
536,547,12,12,1,1,0,12,1,1,1,1,13,13,13,13,0,0,0,0,2,1,1,104,104,104,104,0,1
871,897,27,27,0.9259259259,1,0,27,0.9896373057,1,1,1,27,27,27,27,0,0,0,0,2,1,1,193,193,193,193,0,1
823,832,10,10,0.8333333333,0.9166666667,0,10,0.9111111111,0.9333333333,0.9166666667,0.9222222222,12,12,12,12,0,0,0,0,2,1,1,86,90,86,90,4,1
184,198,14,15,0.9333333333,0.9333333333,1,14.5,0.9090909091,0.9090909091,0.5333333333,0.8434343434,14,15,14,15,1,0,0,0,2,1,1,180,198,180,198,18,1
135,182,48,48,1,1,0,48,1,1,1,1,48,48,48,48,0,0,0,0,2,1,1,318,318,318,318,0,1
1568,1580,13,13,1,1,0,13,1,1,1,1,13,13,13,13,0,0,0,0,2,1,1,115,115,115,115,0,1
27,46,20,20,1,1,0,20,1,1,1,1,20,20,20,20,0,0,0,0,2,1,1,261,261,261,261,0,1
346,377,32,32,1,1,0,32,1,1,1,1,32,32,32,32,0,0,0,0,2,1,1,398,398,398,398,0,1
548,570,23,23,1,1,0,23,1,1,1,1,25,25,25,25,0,0,0,0,2,1,1,187,187,187,187,0,1
265,281,17,17,1,1,0,17,1,1,1,1,19,19,19,19,0,0,0,0,2,1,1,179,179,179,179,0,1
592,602,11,11,1,1,0,11,1,1,1,1,12,12,12,12,0,0,0,0,2,1,1,76,76,76,76,0,1
1,68,68,68,1,1,0,68,1,1,1,1,47,47,47,47,0,0,0,0,0,0,0,325,325,325,325,0,1
126,138,13,13,1,1,0,13,1,1,1,1,13,13,13,13,0,0,0,0,2,1,1,111,111,111,111,0,1
48,62,15,15,1,1,0,15,1,1,1,1,16,16,16,16,0,0,0,0,2,1,1,119,119,119,119,0,1
133,146,12,14,0.5,0.7857142857,2,13,0.7034482759,0.7931034483,0.3571428571,0.6689655172,12,14,12,14,2,0,0,0,2,1,1,115,145,115,145,30,1
228,241,14,14,1,1,0,14,1,1,1,1,14,14,14,14,0,0,0,0,2,1,1,107,107,107,107,0,1
409,428,20,20,1,1,0,20,1,1,1,1,21,21,21,21,0,0,0,0,2,1,1,189,189,189,189,0,1
633,646,14,14,0.8666666667,0.9333333333,0,14,0.9285714286,0.9523809524,0.5333333333,0.7976190476,15,15,15,15,0,3,2,5,2,1,1,84,80,80,84,4,0
335,350,16,16,1,1,0,16,1,1,1,1,16,16,16,16,0,0,0,0,2,1,1,163,163,163,163,0,1
208,241,34,34,0.9428571429,0.9428571429,0,34,0.9847328244,0.9847328244,0.2,0.7353689567,35,35,35,35,0,0,0,0,2,1,1,393,387,387,393,6,1
522,544,23,23,0.88,1,0,23,0.9786096257,1,1,1,25,25,25,25,0,0,0,0,2,1,1,187,187,187,187,0,1
206,217,12,12,0.5833333333,0.9166666667,0,12,0.8559322034,0.9152542373,0.3333333333,0.7542372881,12,12,12,12,0,0,0,0,2,1,1,112,118,112,118,6,1
695,714,20,20,0.9523809524,0.9523809524,0,20,0.9912280702,0.9912280702,0.9523809524,0.9912280702,21,21,21,21,0,0,0,0,2,1,1,114,114,114,114,0,1
328,366,39,39,1,1,0,39,1,1,1,1,39,39,39,39,0,0,0,0,2,1,1,296,296,296,296,0,1
548,570,18,23,0.68,0.72,5,20.5,0.7165775401,0.7326203209,0.32,0.5989304813,20,25,20,25,5,0,0,0,2,1,1,137,187,137,187,50,1
100,137,38,38,1,1,0,38,1,1,1,1,36,36,36,36,0,0,0,0,4,2,2,288,288,288,288,0,0
48,62,15,15,1,1,0,15,1,1,1,1,16,16,16,16,0,0,0,0,2,1,1,119,119,119,119,0,1
80,96,17,17,1,1,0,17,1,1,1,1,17,17,17,17,0,0,0,0,2,1,1,125,125,125,125,0,1
842,857,15,16,0.5,0.875,1,15.5,0.8095238095,0.9285714286,0.8125,0.9047619048,15,16,15,16,1,0,0,0,2,1,1,120,126,120,126,6,1
164,186,20,23,0.7826086957,0.8260869565,3,21.5,0.8775510204,0.8911564626,0.4347826087,0.7210884354,20,23,20,23,3,1,1,2,2,1,1,135,147,135,147,12,1
667,685,19,19,1,1,0,19,1,1,1,1,21,21,21,21,0,0,0,0,2,1,1,149,149,149,149,0,1
261,289,29,29,0.9310344828,1,0,29,0.9929078014,1,1,1,29,29,29,29,0,0,0,0,2,1,1,282,282,282,282,0,0
159,173,15,15,1,1,0,15,1,1,1,1,15,15,15,15,0,0,0,0,2,1,1,190,190,190,190,0,1
1,157,157,157,1,1,0,157,1,1,1,1,142,142,142,142,0,0,0,0,0,0,0,1240,1240,1240,1240,0,1
382,392,11,11,0.8181818182,1,0,11,0.980952381,1,1,1,11,11,11,11,0,0,0,0,2,1,1,105,105,105,105,0,1
99,111,13,13,1,1,0,13,1,1,1,1,13,13,13,13,0,0,0,0,2,1,1,117,117,117,117,0,1
193,203,11,11,0.8333333333,0.9166666667,0,11,0.9732142857,0.9821428571,0.9166666667,0.9821428571,12,12,12,12,0,0,0,0,2,1,1,112,110,110,112,2,0
648,665,18,23,0.68,0.72,5,20.5,0.7165775401,0.7326203209,0.32,0.5989304813,25,20,20,25,5,0,0,0,2,1,1,187,137,137,187,50,1
308,322,15,15,1,1,0,15,1,1,1,1,15,15,15,15,0,0,0,0,2,1,1,162,162,162,162,0,1
667,685,18,19,0.8571428571,0.9047619048,1,18.5,0.8724832215,0.8926174497,0.7142857143,0.8187919463,20,21,20,21,1,0,0,0,2,1,1,137,149,137,149,12,1
288,298,11,11,0.6666666667,1,0,11,0.9621212121,1,1,1,12,12,12,12,0,0,0,0,2,1,1,132,132,132,132,0,1
546,568,18,23,0.68,0.72,5,20.5,0.7165775401,0.7326203209,0.32,0.5989304813,20,25,20,25,5,0,0,0,2,1,1,137,187,137,187,50,1
598,617,18,20,0.3,0.9,2,19,0.8341708543,0.9296482412,0.7,0.8994974874,18,20,18,20,2,0,0,0,2,1,1,185,199,185,199,14,1
93,125,33,33,0.8529411765,0.9117647059,0,33,0.978021978,0.9853479853,0.9117647059,0.9853479853,34,34,34,34,0,1,1,2,4,2,2,273,273,273,273,0,1
544,553,10,10,0.9,1,0,10,0.9758064516,1,0.9,0.9919354839,10,10,10,10,0,0,0,0,2,1,1,124,124,124,124,0,1
790,801,12,13,0.5384615385,0.8461538462,1,12.5,0.8925619835,0.9421487603,0.3076923077,0.7768595041,13,12,12,13,1,0,0,0,2,1,1,121,115,115,121,6,1
249,265,17,17,1,1,0,17,1,1,1,1,19,19,19,19,0,0,0,0,2,1,1,179,179,179,179,0,1
252,283,32,32,1,1,0,32,1,1,1,1,33,33,33,33,0,0,0,0,2,1,1,235,235,235,235,0,1
67,82,16,16,1,1,0,16,1,1,1,1,16,16,16,16,0,0,0,0,2,1,1,108,108,108,108,0,1
110,125,16,16,1,1,0,16,1,1,1,1,18,18,18,18,0,2,2,4,2,1,1,185,185,185,185,0,1
232,284,39,53,0.2909090909,0.2909090909,14,46,0.8043956044,0.8285714286,0.1090909091,0.5362637363,41,55,41,55,14,0,0,0,2,1,1,455,424,424,455,31,1
940,952,13,13,0.5384615385,0.9230769231,0,13,0.9344262295,0.9918032787,0.6923076923,0.9508196721,13,13,13,13,0,0,0,0,2,1,1,122,121,121,122,1,1
1401,1417,17,17,0.4705882353,0.8235294118,0,17,0.8758169935,0.9673202614,0.4117647059,0.862745098,17,17,17,17,0,0,0,0,2,1,1,149,153,149,153,4,1
112,128,17,17,0.7368421053,0.9473684211,0,17,0.9285714286,0.956043956,0.9473684211,0.9505494505,19,19,19,19,0,1,0,1,2,1,1,182,176,176,182,6,1
1467,1481,15,15,1,1,0,15,1,1,1,1,15,15,15,15,0,0,0,0,2,1,1,104,104,104,104,0,1
705,715,7,11,0.3,0.3,4,9,0.8333333333,0.8611111111,0.3,0.8611111111,6,10,6,10,4,1,1,2,4,2,2,62,72,62,72,10,0
624,643,20,20,0.8571428571,1,0,20,0.9806451613,1,1,1,21,21,21,21,0,1,1,2,4,2,2,155,155,155,155,0,1
264,264,1,9,0,0,8,5,0.3125,0.515625,0,0.40625,8,2,2,8,6,0,0,0,3,2,1,64,56,56,64,8,0
335,346,12,12,1,1,0,12,1,1,1,1,12,12,12,12,0,0,0,0,2,1,1,120,120,120,120,0,1
37,48,12,12,1,1,0,12,1,1,1,1,12,12,12,12,0,0,0,0,2,1,1,78,78,78,78,0,1
322,360,39,39,1,1,0,39,1,1,1,1,39,39,39,39,0,0,0,0,2,1,1,296,296,296,296,0,1
192,347,156,156,0.9915254237,0.9915254237,0,156,0.9901477833,0.9921182266,0.1101694915,0.6679802956,118,118,118,118,0,1,1,2,2,1,1,1015,1007,1007,1015,8,1
544,574,31,31,0.84375,0.96875,0,31,0.9520295203,0.9889298893,0.96875,0.9741697417,32,32,32,32,0,2,2,4,4,2,2,269,271,269,271,2,1
204,220,17,17,1,1,0,17,1,1,1,1,17,17,17,17,0,0,0,0,2,1,1,220,220,220,220,0,1
113,124,12,12,1,1,0,12,1,1,1,1,12,12,12,12,0,0,0,0,2,1,1,67,67,67,67,0,1
126,145,20,20,1,1,0,20,1,1,1,1,20,20,20,20,0,0,0,0,2,1,1,120,120,120,120,0,1
202,265,64,64,1,1,0,64,1,1,1,1,64,64,64,64,0,0,0,0,2,1,1,511,511,511,511,0,1
629,646,18,18,0.9,1,0,18,0.9854014599,1,1,1,20,20,20,20,0,0,0,0,2,1,1,137,137,137,137,0,1
8,29,22,24,0.6538461538,0.8461538462,2,23,0.7957446809,0.8510638298,0.6923076923,0.8,26,23,23,26,3,0,0,0,2,1,1,235,200,200,235,35,1
382,392,11,13,0.5384615385,0.8461538462,2,12,0.7933884298,0.867768595,0.3076923077,0.7107438017,13,11,11,13,2,0,0,0,2,1,1,121,105,105,121,16,1
159,173,15,15,1,1,0,15,1,1,1,1,15,15,15,15,0,0,0,0,2,1,1,190,190,190,190,0,1
1301,1313,13,13,0.5333333333,1,0,13,0.838028169,1,1,1,15,15,15,15,0,1,1,2,2,1,1,142,142,142,142,0,1
26,42,17,17,1,1,0,17,1,1,1,1,17,17,17,17,0,0,0,0,2,1,1,233,233,233,233,0,1
167,178,12,12,1,1,0,12,1,1,1,1,12,12,12,12,0,0,0,0,2,1,1,79,79,79,79,0,1
619,639,18,21,0.2857142857,0.8571428571,3,19.5,0.8058252427,0.8980582524,0.6666666667,0.8689320388,18,21,18,21,3,0,0,0,2,1,1,185,206,185,206,21,1
560,571,12,14,0.4285714286,0.7857142857,2,13,0.7553956835,0.8201438849,0.2857142857,0.6834532374,14,12,12,14,2,0,0,0,2,1,1,139,114,114,139,25,1
648,667,20,20,0.8571428571,1,0,20,0.9806451613,1,1,1,21,21,21,21,0,1,1,2,4,2,2,155,155,155,155,0,1
870,896,27,27,0.9259259259,1,0,27,0.9896373057,1,1,1,27,27,27,27,0,0,0,0,2,1,1,193,193,193,193,0,1
546,570,25,25,0.8461538462,1,0,25,0.9759615385,1,1,1,26,26,26,26,0,1,1,2,4,2,2,208,208,208,208,0,1
1104,1137,34,34,1,1,0,34,1,1,1,1,13,13,13,13,0,1,1,2,4,2,2,110,110,110,110,0,1
24,66,43,43,1,1,0,43,1,1,1,1,38,38,38,38,0,2,2,4,2,1,1,274,274,274,274,0,1
220,231,12,13,0.5384615385,0.8461538462,1,12.5,0.7933884298,0.9256198347,0.3076923077,0.7272727273,13,12,12,13,1,0,0,0,2,1,1,121,118,118,121,3,1
394,404,11,11,1,1,0,11,1,1,1,1,12,12,12,12,0,0,0,0,2,1,1,159,159,159,159,0,1
100,140,41,41,0.5434782609,0.8913043478,0,41,0.8987951807,0.956626506,0.7173913043,0.9373493976,46,46,46,46,0,1,1,2,2,1,1,415,415,415,415,0,1
536,547,12,12,1,1,0,12,1,1,1,1,13,13,13,13,0,0,0,0,2,1,1,104,104,104,104,0,1
293,304,12,12,1,1,0,12,1,1,1,1,14,14,14,14,0,0,0,0,2,1,1,91,91,91,91,0,1
99,121,23,23,1,1,0,23,1,1,1,1,23,23,23,23,0,0,0,0,2,1,1,177,177,177,177,0,1
629,646,18,18,1,1,0,18,1,1,1,1,20,20,20,20,0,0,0,0,2,1,1,137,137,137,137,0,1
31,54,24,24,1,1,0,24,1,1,1,1,24,24,24,24,0,0,0,0,2,1,1,164,164,164,164,0,1
365,375,11,14,0.6875,0.6875,3,12.5,0.6721311475,0.6967213115,0.3125,0.5491803279,16,13,13,16,3,0,0,0,2,1,1,122,95,95,122,27,1
110,126,17,17,0.5263157895,0.8947368421,0,17,0.8901734104,0.9421965318,0.4210526316,0.710982659,19,19,19,19,0,1,1,2,2,1,1,165,173,165,173,8,0
280,289,10,10,1,1,0,10,1,1,1,1,11,11,11,11,0,0,0,0,2,1,1,131,131,131,131,0,1
181,195,12,15,0.8,0.8,3,13.5,0.8656716418,0.8656716418,0.7333333333,0.8507462687,12,15,12,15,3,0,0,0,2,1,1,58,67,58,67,9,1
955,967,12,13,0.5384615385,0.8461538462,1,12.5,0.7933884298,0.9256198347,0.3076923077,0.7272727273,12,13,12,13,1,0,0,0,2,1,1,118,121,118,121,3,1
629,646,18,18,0.9,1,0,18,0.9854014599,1,1,1,20,20,20,20,0,0,0,0,2,1,1,137,137,137,137,0,1
149,157,9,9,1,1,0,9,1,1,1,1,11,11,11,11,0,0,0,0,2,1,1,105,105,105,105,0,1
306,344,39,39,0.8974358974,0.8974358974,0,39,0.9506578947,0.9506578947,0.4615384615,0.7105263158,39,39,39,39,0,0,0,0,2,1,1,304,297,297,304,7,1
1403,1419,17,17,1,1,0,17,1,1,1,1,16,16,16,16,0,1,1,2,2,1,1,142,142,142,142,0,1
570,590,21,21,1,1,0,21,1,1,1,1,23,23,23,23,0,0,0,0,2,1,1,166,166,166,166,0,1
32,37,6,6,0.3333333333,0.8333333333,0,6,0.7037037037,0.9259259259,0.6666666667,0.8888888889,6,6,6,6,0,0,0,0,2,1,1,25,27,25,27,2,0
984,1040,57,59,0.9333333333,0.9333333333,2,58,0.9837837838,0.9837837838,0.9333333333,0.9837837838,60,58,58,60,2,0,0,0,2,1,1,370,365,365,370,5,1
244,255,12,12,1,1,0,12,1,1,1,1,13,13,13,13,0,2,2,4,2,1,1,152,152,152,152,0,1
298,307,10,10,1,1,0,10,1,1,1,1,10,10,10,10,0,0,0,0,2,1,1,45,45,45,45,0,1
194,203,10,10,1,1,0,10,1,1,1,1,8,8,8,8,0,0,0,0,2,1,1,59,59,59,59,0,1
371,394,24,24,1,1,0,24,1,1,1,1,24,24,24,24,0,0,0,0,2,1,1,344,344,344,344,0,1
1083,1095,13,14,0.5714285714,0.9285714286,1,13.5,0.8916666667,0.9416666667,0.4285714286,0.825,14,13,13,14,1,0,0,0,2,1,1,120,113,113,120,7,1
520,550,31,31,0.84375,0.96875,0,31,0.9520295203,0.9889298893,0.96875,0.9741697417,32,32,32,32,0,2,2,4,4,2,2,271,269,269,271,2,1
372,403,32,32,1,1,0,32,1,1,1,1,32,32,32,32,0,0,0,0,2,1,1,281,281,281,281,0,1
1,63,63,63,1,1,0,63,1,1,1,1,57,57,57,57,0,0,0,0,0,0,0,545,545,545,545,0,1
90,172,83,83,1,1,0,83,1,1,1,1,83,83,83,83,0,0,0,0,2,1,1,756,756,756,756,0,1
648,667,20,20,0.8571428571,1,0,20,0.9806451613,1,1,1,21,21,21,21,0,1,1,2,4,2,2,155,155,155,155,0,1
170,182,13,14,0.5,0.7142857143,1,13.5,0.7724550898,0.8562874251,0.4285714286,0.7365269461,14,13,13,14,1,0,0,0,2,1,1,167,144,144,167,23,1
587,597,11,11,1,1,0,11,1,1,1,1,12,12,12,12,0,0,0,0,2,1,1,76,76,76,76,0,1
425,436,12,14,0.4285714286,0.7857142857,2,13,0.693877551,0.7619047619,0.2857142857,0.6326530612,14,12,12,14,2,0,0,0,2,1,1,147,112,112,147,35,1
590,601,12,12,0.5,0.8333333333,0,12,0.7731092437,0.8907563025,0.3333333333,0.7142857143,12,12,12,12,0,0,0,0,2,1,1,108,119,108,119,11,1
648,665,18,21,0.7391304348,0.7826086957,3,19.5,0.7951807229,0.813253012,0.347826087,0.656626506,23,20,20,23,3,0,0,0,2,1,1,166,137,137,166,29,1
570,590,21,23,0.84,0.88,2,22,0.8395721925,0.871657754,0.68,0.807486631,25,23,23,25,2,0,0,0,2,1,1,187,166,166,187,21,1
208,223,16,16,1,1,0,16,1,1,1,1,16,16,16,16,0,1,1,2,2,1,1,215,215,215,215,0,1
151,167,17,17,1,1,0,17,1,1,1,1,17,17,17,17,0,0,0,0,2,1,1,101,101,101,101,0,1
8,34,27,27,0.7,1,0,27,0.9586206897,1,1,1,20,20,20,20,0,2,2,4,2,1,1,145,145,145,145,0,1
346,372,15,27,0.1379310345,0.2413793103,12,21,0.3064516129,0.4946236559,0.1379310345,0.3494623656,15,29,15,29,14,0,0,0,2,1,1,121,186,121,186,65,0
1347,1360,14,14,0.6428571429,0.7857142857,0,14,0.8217054264,0.8449612403,0.3571428571,0.7054263566,14,14,14,14,0,0,0,0,2,1,1,129,111,111,129,18,1
99,111,13,13,1,1,0,13,1,1,1,1,13,13,13,13,0,0,0,0,2,1,1,117,117,117,117,0,1
104,113,10,10,0.1,0.7,0,10,0.5454545455,0.8181818182,0.1,0.6233766234,10,10,10,10,0,0,0,0,2,1,1,74,77,74,77,3,0
309,326,18,18,0.3333333333,1,0,18,0.8864864865,1,1,1,18,18,18,18,0,0,0,0,2,1,1,185,185,185,185,0,1
648,665,18,21,0.7391304348,0.7826086957,3,19.5,0.7951807229,0.813253012,0.347826087,0.656626506,23,20,20,23,3,0,0,0,2,1,1,166,137,137,166,29,1
80,90,11,11,1,1,0,11,1,1,1,1,11,11,11,11,0,0,0,0,2,1,1,82,82,82,82,0,1
422,457,36,36,1,1,0,36,1,1,1,1,38,38,38,38,0,0,0,0,2,1,1,349,349,349,349,0,1
808,828,21,21,1,1,0,21,1,1,1,1,21,21,21,21,0,0,0,0,2,1,1,194,194,194,194,0,1
413,448,36,36,1,1,0,36,1,1,1,1,38,38,38,38,0,0,0,0,2,1,1,349,349,349,349,0,1
382,392,11,11,0.6363636364,1,0,11,0.9619047619,1,1,1,11,11,11,11,0,0,0,0,2,1,1,105,105,105,105,0,1
113,124,12,12,1,1,0,12,1,1,1,1,13,13,13,13,0,0,0,0,2,1,1,95,95,95,95,0,1
35,50,16,16,1,1,0,16,1,1,1,1,17,17,17,17,0,0,0,0,2,1,1,135,135,135,135,0,1
874,900,27,27,1,1,0,27,1,1,1,1,27,27,27,27,0,0,0,0,2,1,1,193,193,193,193,0,1
522,544,23,23,1,1,0,23,1,1,1,1,25,25,25,25,0,0,0,0,2,1,1,187,187,187,187,0,1
710,722,13,13,1,1,0,13,1,1,1,1,19,19,19,19,0,0,0,0,2,1,1,169,169,169,169,0,1
546,568,23,23,1,1,0,23,1,1,1,1,25,25,25,25,0,0,0,0,2,1,1,187,187,187,187,0,1
157,191,35,35,1,1,0,35,1,1,1,1,35,35,35,35,0,2,2,4,4,2,2,268,268,268,268,0,1
575,600,26,29,0.6333333333,0.6666666667,3,27.5,0.6811023622,0.7244094488,0.2,0.5511811024,30,27,27,30,3,0,0,0,2,1,1,254,217,217,254,37,1
667,685,18,19,0.8571428571,0.9047619048,1,18.5,0.8724832215,0.8926174497,0.7142857143,0.8187919463,20,21,20,21,1,0,0,0,2,1,1,137,149,137,149,12,1
395,405,11,12,0.5833333333,0.8333333333,1,11.5,0.8240740741,0.9351851852,0.3333333333,0.75,12,11,11,12,1,0,0,0,2,1,1,108,105,105,108,3,1
19,34,16,16,1,1,0,16,1,1,1,1,16,16,16,16,0,0,0,0,2,1,1,119,119,119,119,0,1
629,646,18,19,0.8571428571,0.9047619048,1,18.5,0.8724832215,0.8926174497,0.7142857143,0.8187919463,21,20,20,21,1,0,0,0,2,1,1,149,137,137,149,12,1
367,379,13,13,1,1,0,13,1,1,1,1,13,13,13,13,0,0,0,0,2,1,1,124,124,124,124,0,1
687,703,17,17,1,1,0,17,1,1,1,1,17,17,17,17,0,0,0,0,2,1,1,84,84,84,84,0,1
113,124,12,12,1,1,0,12,1,1,1,1,12,12,12,12,0,0,0,0,2,1,1,67,67,67,67,0,1
827,857,31,31,1,1,0,31,1,1,1,1,32,32,32,32,0,0,0,0,2,1,1,243,243,243,243,0,1
1,19,19,19,1,1,0,19,1,1,1,1,17,17,17,17,0,0,0,0,0,0,0,159,159,159,159,0,1
88,136,49,49,0.5818181818,0.9090909091,0,49,0.8962075848,0.9520958084,0.3818181818,0.7285429142,55,55,55,55,0,1,1,2,2,1,1,493,501,493,501,8,1
238,247,10,10,0.8,0.8,0,10,0.84,0.86,0.4,0.66,10,10,10,10,0,0,0,0,2,1,1,50,44,44,50,6,1
64,88,25,25,0.75,0.9642857143,0,25,0.9382716049,0.9670781893,0.9642857143,0.962962963,28,28,28,28,0,1,0,1,2,1,1,243,237,237,243,6,1
315,337,20,23,0.7826086957,0.7826086957,3,21.5,0.8767123288,0.9178082192,0.652173913,0.8219178082,20,23,20,23,3,0,0,0,2,1,1,144,146,144,146,2,1
667,685,18,19,0.8571428571,0.9047619048,1,18.5,0.8724832215,0.8926174497,0.7142857143,0.8187919463,20,21,20,21,1,0,0,0,2,1,1,137,149,137,149,12,1
528,565,38,38,1,1,0,38,1,1,1,1,38,38,38,38,0,0,0,0,4,2,2,368,368,368,368,0,1
470,488,19,19,1,1,0,19,1,1,1,1,19,19,19,19,0,0,0,0,2,1,1,195,195,195,195,0,1
36,66,31,31,1,1,0,31,1,1,1,1,28,28,28,28,0,1,1,2,4,2,2,198,198,198,198,0,1
629,646,18,21,0.7391304348,0.7826086957,3,19.5,0.7951807229,0.813253012,0.347826087,0.656626506,23,20,20,23,3,0,0,0,2,1,1,166,137,137,166,29,1
963,973,11,11,0.8181818182,1,0,11,0.9347826087,1,1,1,11,11,11,11,0,0,0,0,2,1,1,46,46,46,46,0,1
570,590,18,21,0.7391304348,0.7826086957,3,19.5,0.7951807229,0.813253012,0.347826087,0.656626506,20,23,20,23,3,0,0,0,2,1,1,137,166,137,166,29,1
1,56,56,59,0.9782608696,0.9782608696,3,57.5,0.9967845659,0.9967845659,0.9782608696,0.9967845659,46,46,46,46,0,3,3,6,2,1,1,311,311,311,311,0,1
194,203,10,10,1,1,0,10,1,1,1,1,8,8,8,8,0,0,0,0,2,1,1,59,59,59,59,0,1
113,124,12,12,1,1,0,12,1,1,1,1,12,12,12,12,0,0,0,0,2,1,1,67,67,67,67,0,1
282,291,10,10,1,1,0,10,1,1,1,1,10,10,10,10,0,0,0,0,2,1,1,45,45,45,45,0,1
176,192,17,18,0.6666666667,0.7222222222,1,17.5,0.7058823529,0.8137254902,0.3333333333,0.6274509804,18,17,17,18,1,0,0,0,2,1,1,102,88,88,102,14,1
424,432,9,9,1,1,0,9,1,1,1,1,10,10,10,10,0,3,3,6,2,1,1,136,136,136,136,0,1
67,80,14,14,1,1,0,14,1,1,1,1,14,14,14,14,0,0,0,0,2,1,1,91,91,91,91,0,0
63,98,36,36,0.775,0.975,0,36,0.9475218659,0.9766763848,0.925,0.970845481,40,40,40,40,0,1,1,2,2,1,1,343,335,335,343,8,1
524,540,17,17,1,1,0,17,1,1,1,1,17,17,17,17,0,1,1,2,2,1,1,158,158,158,158,0,1
9,34,22,26,0.8076923077,0.8846153846,4,24,0.8626609442,0.8798283262,0.8846153846,0.8798283262,23,26,23,26,3,1,1,2,2,1,1,205,233,205,233,28,1
629,648,20,20,0.8571428571,1,0,20,0.9806451613,1,1,1,21,21,21,21,0,1,1,2,4,2,2,155,155,155,155,0,1
64,79,16,16,1,1,0,16,1,1,1,1,16,16,16,16,0,0,0,0,2,1,1,120,120,120,120,0,1
228,261,34,34,1,1,0,34,1,1,1,1,34,34,34,34,0,1,1,2,4,2,2,311,311,311,311,0,1
588,608,21,21,1,1,0,21,1,1,1,1,24,24,24,24,0,1,1,2,2,1,1,180,180,180,180,0,1
110,260,151,151,1,1,0,151,1,1,1,1,142,142,142,142,0,1,1,2,4,2,2,1042,1042,1042,1042,0,1
14,37,22,24,0.6538461538,0.8461538462,2,23,0.7957446809,0.8510638298,0.6923076923,0.8,23,26,23,26,3,0,0,0,2,1,1,200,235,200,235,35,1
206,217,12,12,0.5,0.9166666667,0,12,0.8655462185,0.974789916,0.9166666667,0.8991596639,12,12,12,12,0,0,0,0,2,1,1,119,118,118,119,1,1
776,787,12,12,0.6666666667,0.9166666667,0,12,0.8596491228,0.9298245614,0.4166666667,0.7807017544,12,12,12,12,0,0,0,0,2,1,1,114,108,108,114,6,1
135,182,48,48,1,1,0,48,1,1,1,1,48,48,48,48,0,0,0,0,2,1,1,318,318,318,318,0,1
110,197,79,88,0.875,0.8863636364,9,83.5,0.9318181818,0.9338842975,0.7159090909,0.8595041322,79,88,79,88,9,0,0,0,2,1,1,452,484,452,484,32,1
322,360,39,39,1,1,0,39,1,1,1,1,39,39,39,39,0,0,0,0,2,1,1,296,296,296,296,0,1
139,176,22,38,0.1052631579,0.1315789474,16,30,0.3032786885,0.4713114754,0.1052631579,0.3401639344,22,38,22,38,16,0,0,0,2,1,1,151,244,151,244,93,0
778,806,29,29,1,1,0,29,1,1,1,1,35,35,35,35,0,0,0,0,2,1,1,386,386,386,386,0,1
487,504,18,18,0.9,1,0,18,0.9854014599,1,1,1,20,20,20,20,0,0,0,0,2,1,1,137,137,137,137,0,1
356,450,95,95,0.984375,0.984375,0,95,0.9883381924,0.9941690962,0.34375,0.7172011662,64,64,64,64,0,0,0,0,4,2,2,343,343,343,343,0,1
110,197,88,88,1,1,0,88,1,1,1,1,88,88,88,88,0,0,0,0,2,1,1,484,484,484,484,0,1
572,591,20,20,0.6666666667,0.9523809524,0,20,0.9210526316,0.9912280702,0.9523809524,0.9912280702,21,21,21,21,0,0,0,0,2,1,1,114,114,114,114,0,1
707,726,20,20,0.9523809524,0.9523809524,0,20,0.9912280702,0.9912280702,0.9523809524,0.9912280702,21,21,21,21,0,0,0,0,2,1,1,114,114,114,114,0,1
210,223,14,14,0.6153846154,0.8461538462,0,14,0.8333333333,0.88,0.2307692308,0.6266666667,13,13,13,13,0,0,0,0,4,2,2,150,133,133,150,17,0
1242,1253,12,12,0.6428571429,0.6428571429,0,12,0.8345864662,0.8646616541,0.2857142857,0.7819548872,14,13,13,14,1,0,0,0,2,1,1,133,118,118,133,15,1
570,590,21,21,1,1,0,21,1,1,1,1,23,23,23,23,0,0,0,0,2,1,1,166,166,166,166,0,1
450,543,94,94,0.9784946237,1,0,94,0.9974683544,1,0.9892473118,0.9987341772,93,93,93,93,0,0,0,0,4,2,2,790,790,790,790,0,1
187,203,16,17,0.3529411765,0.7058823529,1,16.5,0.7527472527,0.8626373626,0.2352941176,0.6868131868,16,17,16,17,1,0,0,0,2,1,1,163,182,163,182,19,1
525,543,19,21,0.7391304348,0.7826086957,2,20,0.8192771084,0.8614457831,0.347826087,0.6987951807,23,21,21,23,2,0,0,0,2,1,1,166,149,149,166,17,1
126,138,13,13,1,1,0,13,1,1,1,1,13,13,13,13,0,0,0,0,2,1,1,111,111,111,111,0,1
439,483,45,46,1,1,1,45.5,1,1,1,1,31,31,31,31,0,3,3,6,4,2,2,153,153,153,153,0,1
23,39,17,20,0.1,0.2,3,18.5,0.3333333333,0.5481481481,0.1,0.3555555556,20,17,17,20,3,0,0,0,2,1,1,110,135,110,135,25,1
317,330,14,19,0.6842105263,0.7368421053,5,16.5,0.7205882353,0.7279411765,0.6842105263,0.7205882353,19,14,14,19,5,0,0,0,2,1,1,136,99,99,136,37,1
629,646,18,23,0.68,0.72,5,20.5,0.7165775401,0.7326203209,0.32,0.5989304813,25,20,20,25,5,0,0,0,2,1,1,187,137,137,187,50,1
716,726,10,11,0.7692307692,0.7692307692,1,10.5,0.8181818182,0.8282828283,0.2307692308,0.6262626263,12,13,12,13,1,0,0,0,2,1,1,83,99,83,99,16,1
211,239,29,29,1,1,0,29,1,1,1,1,28,28,28,28,0,1,1,2,2,1,1,196,196,196,196,0,1
117,141,25,26,0.6538461538,0.6538461538,1,25.5,0.8872403561,0.8872403561,0.4230769231,0.8486646884,26,25,25,26,1,0,0,0,2,1,1,337,299,299,337,38,1
105,126,22,22,0.7857142857,0.9285714286,0,22,0.9519230769,0.9759615385,0.9285714286,0.9759615385,28,28,28,28,0,1,1,2,2,1,1,208,205,205,208,3,1
546,568,23,23,0.88,1,0,23,0.9786096257,1,1,1,25,25,25,25,0,0,0,0,2,1,1,187,187,187,187,0,1
330,345,16,16,0.875,0.875,0,16,0.8378378378,0.8468468468,0.5,0.7297297297,16,16,16,16,0,0,0,0,2,1,1,94,111,94,111,17,1
164,183,20,20,1,1,0,20,1,1,1,1,19,19,19,19,0,1,1,2,4,2,2,136,136,136,136,0,1
249,265,17,17,1,1,0,17,1,1,1,1,19,19,19,19,0,0,0,0,2,1,1,179,179,179,179,0,1
43,52,10,10,1,1,0,10,1,1,1,1,10,10,10,10,0,0,0,0,2,1,1,88,88,88,88,0,1
629,646,18,23,0.68,0.72,5,20.5,0.7165775401,0.7326203209,0.32,0.5989304813,25,20,20,25,5,0,0,0,2,1,1,187,137,137,187,50,1
149,165,17,20,0.4,0.8,3,18.5,0.752293578,0.8302752294,0.2,0.6788990826,20,17,17,20,3,0,0,0,2,1,1,218,182,182,218,36,1
522,544,21,23,0.84,0.88,2,22,0.8395721925,0.871657754,0.68,0.807486631,23,25,23,25,2,0,0,0,2,1,1,166,187,166,187,21,1
555,565,11,13,0.5384615385,0.8461538462,2,12,0.8941176471,0.9176470588,0.6923076923,0.8941176471,13,11,11,13,2,2,2,4,2,1,1,170,156,156,170,14,1
440,452,13,13,1,1,0,13,1,1,1,1,13,13,13,13,0,0,0,0,2,1,1,133,133,133,133,0,1
159,173,15,15,1,1,0,15,1,1,1,1,15,15,15,15,0,0,0,0,2,1,1,190,190,190,190,0,1
48,66,19,19,0.7894736842,1,0,19,0.9754601227,1,1,1,19,19,19,19,0,0,0,0,2,1,1,163,163,163,163,0,1
293,304,12,12,1,1,0,12,1,1,1,1,14,14,14,14,0,0,0,0,2,1,1,91,91,91,91,0,1
107,194,88,88,1,1,0,88,1,1,1,1,88,88,88,88,0,0,0,0,2,1,1,484,484,484,484,0,1
18,33,15,16,0.125,0.3125,1,15.5,0.4153846154,0.5615384615,0.1875,0.4153846154,15,16,15,16,1,0,0,0,2,1,1,97,130,97,130,33,1
381,392,12,12,1,1,0,12,1,1,1,1,14,14,14,14,0,0,0,0,2,1,1,124,124,124,124,0,1
202,265,64,64,1,1,0,64,1,1,1,1,64,64,64,64,0,0,0,0,2,1,1,511,511,511,511,0,1
819,836,18,18,0.3529411765,1,0,18,0.875,1,1,1,17,17,17,17,0,1,1,2,4,2,2,192,192,192,192,0,1
1876,1886,11,11,0.3333333333,0.6666666667,0,11,0.5968379447,0.6245059289,0.1111111111,0.4584980237,18,13,13,18,5,0,0,0,2,1,1,253,158,158,253,95,1
56,65,10,10,0.4,0.7,0,10,0.4912280702,0.701754386,0.4,0.5614035088,10,10,10,10,0,0,0,0,2,1,1,43,57,43,57,14,0
291,308,16,18,0.3333333333,0.8888888889,2,17,0.8162162162,0.9243243243,0.6666666667,0.8918918919,16,18,16,18,2,0,0,0,2,1,1,171,185,171,185,14,1
445,483,39,39,1,1,0,39,1,1,1,1,38,38,38,38,0,1,1,2,2,1,1,208,208,208,208,0,1
63,79,13,17,0.3888888889,0.7777777778,4,15,0.7131782946,0.8062015504,0.7777777778,0.8062015504,14,18,14,18,4,0,0,0,2,1,1,104,129,104,129,25,1
43,52,10,10,1,1,0,10,1,1,1,1,10,10,10,10,0,0,0,0,2,1,1,88,88,88,88,0,1
187,231,45,45,0.9782608696,0.9782608696,0,45,0.985645933,0.985645933,0.1739130435,0.6722488038,46,46,46,46,0,1,1,2,2,1,1,418,412,412,418,6,1
570,590,19,21,0.7391304348,0.7826086957,2,20,0.8192771084,0.8614457831,0.347826087,0.6987951807,21,23,21,23,2,0,0,0,2,1,1,149,166,149,166,17,1
356,366,11,13,0.5384615385,0.8461538462,2,12,0.7933884298,0.867768595,0.3076923077,0.7107438017,13,11,11,13,2,0,0,0,2,1,1,121,105,105,121,16,1
135,189,51,55,0.9272727273,0.9272727273,4,53,0.9450800915,0.9450800915,0.5636363636,0.8443935927,51,55,51,55,4,0,0,0,2,1,1,413,437,413,437,24,1
522,552,31,31,0.84375,0.96875,0,31,0.9520295203,0.9889298893,0.96875,0.9741697417,32,32,32,32,0,2,2,4,4,2,2,271,269,269,271,2,0
180,195,16,16,1,1,0,16,1,1,1,1,16,16,16,16,0,3,3,6,2,1,1,139,139,139,139,0,1
73,82,10,10,1,1,0,10,1,1,1,1,10,10,10,10,0,0,0,0,2,1,1,62,62,62,62,0,1
629,646,18,23,0.68,0.72,5,20.5,0.7165775401,0.7326203209,0.32,0.5989304813,25,20,20,25,5,0,0,0,2,1,1,187,137,137,187,50,1
667,685,18,19,0.8571428571,0.9047619048,1,18.5,0.8724832215,0.8926174497,0.7142857143,0.8187919463,20,21,20,21,1,0,0,0,2,1,1,137,149,137,149,12,1
296,321,26,26,1,1,0,26,1,1,1,1,26,26,26,26,0,0,0,0,2,1,1,337,337,337,337,0,1
255,267,13,13,0.9230769231,1,0,13,0.9924242424,1,1,1,13,13,13,13,0,1,1,2,2,1,1,132,132,132,132,0,1
21,30,10,10,0.5,0.8,0,10,0.8852459016,0.9672131148,0.4,0.8360655738,10,10,10,10,0,0,0,0,2,1,1,61,61,61,61,0,1
222,231,10,10,0.9090909091,0.9090909091,0,10,0.9215686275,0.9411764706,0.2727272727,0.6666666667,11,11,11,11,0,1,1,2,2,1,1,100,102,100,102,2,1
670,683,11,14,0.4285714286,0.7857142857,3,12.5,0.6802721088,0.7142857143,0.7857142857,0.7142857143,11,14,11,14,3,0,0,0,2,1,1,105,147,105,147,42,1
1097,1112,16,19,0.5263157895,0.7368421053,3,17.5,0.8333333333,0.92,0.3684210526,0.78,19,16,16,19,3,0,0,0,2,1,1,150,141,141,150,9,1
570,590,21,23,0.84,0.88,2,22,0.8395721925,0.871657754,0.68,0.807486631,25,23,23,25,2,0,0,0,2,1,1,187,166,166,187,21,1
1083,1095,13,15,0.6,0.8666666667,2,14,0.8571428571,0.8968253968,0.6666666667,0.880952381,15,13,13,15,2,0,0,0,2,1,1,126,113,113,126,13,1
762,773,11,12,0.5833333333,0.8333333333,1,11.5,0.8240740741,0.9351851852,0.3333333333,0.75,11,12,11,12,1,0,0,0,2,1,1,105,108,105,108,3,1
667,685,19,19,1,1,0,19,1,1,1,1,21,21,21,21,0,0,0,0,2,1,1,149,149,149,149,0,1
31,46,16,16,1,1,0,16,1,1,1,1,16,16,16,16,0,0,0,0,2,1,1,159,159,159,159,0,1
414,433,20,20,1,1,0,20,1,1,1,1,21,21,21,21,0,0,0,0,2,1,1,189,189,189,189,0,1
26,42,17,17,1,1,0,17,1,1,1,1,17,17,17,17,0,0,0,0,2,1,1,233,233,233,233,0,1
701,709,9,11,0.6153846154,0.7692307692,2,10,0.696969697,0.7272727273,0.3846153846,0.5555555556,13,11,11,13,2,0,0,0,2,1,1,99,75,75,99,24,1
648,665,18,23,0.68,0.72,5,20.5,0.7165775401,0.7326203209,0.32,0.5989304813,25,20,20,25,5,0,0,0,2,1,1,187,137,137,187,50,1
1106,1122,17,18,0.7777777778,0.8333333333,1,17.5,0.8560606061,0.9242424242,0.6666666667,0.8333333333,18,17,17,18,1,0,0,0,2,1,1,129,132,129,132,3,1
433,453,21,21,0.7727272727,0.8181818182,0,21,0.8670886076,0.8924050633,0.7272727273,0.8607594937,21,22,21,22,1,0,0,0,2,1,1,143,158,143,158,15,1
350,379,30,30,1,1,0,30,1,1,1,1,29,29,29,29,0,0,0,0,4,2,2,364,364,364,364,0,1
599,618,20,20,0.9523809524,1,0,20,0.9924242424,1,0.7619047619,0.9393939394,21,21,21,21,0,3,3,6,4,2,2,132,132,132,132,0,1
442,454,13,13,1,1,0,13,1,1,1,1,13,13,13,13,0,0,0,0,2,1,1,133,133,133,133,0,1
407,486,80,80,1,1,0,80,1,1,1,1,80,80,80,80,0,0,0,0,2,1,1,560,560,560,560,0,1
425,450,26,26,1,1,0,26,1,1,1,1,26,26,26,26,0,0,0,0,2,1,1,182,182,182,182,0,1
568,596,29,29,1,1,0,29,1,1,1,1,31,31,31,31,0,0,0,0,2,1,1,336,336,336,336,0,1
99,111,13,13,1,1,0,13,1,1,1,1,13,13,13,13,0,0,0,0,2,1,1,117,117,117,117,0,1
246,302,57,57,1,1,0,57,1,1,1,1,53,53,53,53,0,1,1,2,4,2,2,348,348,348,348,0,1
222,274,53,53,1,1,0,53,1,1,1,1,50,50,50,50,0,1,1,2,2,1,1,324,324,324,324,0,1
571,585,15,15,0.8666666667,1,0,15,0.9863945578,1,1,1,15,15,15,15,0,0,0,0,2,1,1,147,147,147,147,0,1
411,423,13,13,1,1,0,13,1,1,1,1,13,13,13,13,0,2,2,4,2,1,1,115,115,115,115,0,1
314,414,101,101,0.9866666667,0.9866666667,0,101,0.9970760234,0.9970760234,0.2933333333,0.701754386,75,75,75,75,0,2,2,4,4,2,2,682,684,682,684,2,1
414,433,20,20,1,1,0,20,1,1,1,1,21,21,21,21,0,0,0,0,2,1,1,189,189,189,189,0,1
99,111,13,13,1,1,0,13,1,1,1,1,13,13,13,13,0,0,0,0,2,1,1,117,117,117,117,0,1
751,776,26,26,1,1,0,26,1,1,1,1,28,28,28,28,0,0,0,0,2,1,1,257,257,257,257,0,1
544,574,31,31,0.84375,0.96875,0,31,0.9520295203,0.9889298893,0.96875,0.9741697417,32,32,32,32,0,2,2,4,4,2,2,269,271,269,271,2,1
280,289,10,10,1,1,0,10,1,1,1,1,11,11,11,11,0,0,0,0,2,1,1,131,131,131,131,0,1
463,479,17,17,1,1,0,17,1,1,1,1,17,17,17,17,0,0,0,0,2,1,1,119,119,119,119,0,1
649,686,38,38,0.9736842105,0.9736842105,0,38,0.9532374101,0.9604316547,0.3684210526,0.6834532374,38,38,38,38,0,2,2,4,2,1,1,269,278,269,278,9,1
64,80,17,17,0.6315789474,0.8947368421,0,17,0.8922155689,0.9401197605,0.7894736842,0.9221556886,19,19,19,19,0,0,1,1,2,1,1,167,165,165,167,2,1
138,163,26,26,0.9230769231,0.9615384615,0,26,0.9050632911,0.9303797468,0.5769230769,0.753164557,26,26,26,26,0,2,2,4,2,1,1,158,147,147,158,11,1
88,115,23,28,0.75,0.75,5,25.5,0.7596153846,0.8221153846,0.6428571429,0.7692307692,23,28,23,28,5,0,0,0,2,1,1,180,208,180,208,28,1
669,687,18,19,0.8571428571,0.9047619048,1,18.5,0.8724832215,0.8926174497,0.7142857143,0.8187919463,20,21,20,21,1,0,0,0,2,1,1,137,149,137,149,12,1
524,546,23,23,0.88,1,0,23,0.9786096257,1,1,1,25,25,25,25,0,0,0,0,2,1,1,187,187,187,187,0,1
454,470,15,17,0.3529411765,0.7647058824,2,16,0.7840909091,0.8636363636,0.4705882353,0.8011363636,15,17,15,17,2,0,0,0,2,1,1,153,176,153,176,23,1
575,605,31,31,1,1,0,31,1,1,1,1,31,31,31,31,0,0,0,0,2,1,1,241,241,241,241,0,1
243,252,10,10,1,1,0,10,1,1,1,1,10,10,10,10,0,0,0,0,2,1,1,90,90,90,90,0,1
55,69,15,15,1,1,0,15,1,1,1,1,17,17,17,17,0,0,0,0,4,2,2,104,104,104,104,0,1
786,803,18,18,1,1,0,18,1,1,1,1,18,18,18,18,0,0,0,0,2,1,1,131,131,131,131,0,1
280,289,10,10,0.9090909091,0.9090909091,0,10,0.9847328244,0.9847328244,0.9090909091,0.9847328244,11,11,11,11,0,0,0,0,2,1,1,131,129,129,131,2,1
64,80,17,21,0.2857142857,0.7142857143,4,19,0.6875,0.8402777778,0.380952381,0.6944444444,21,17,17,21,4,0,0,0,2,1,1,144,128,128,144,16,1
27,46,20,20,1,1,0,20,1,1,1,1,20,20,20,20,0,0,0,0,2,1,1,261,261,261,261,0,1
522,544,18,23,0.68,0.72,5,20.5,0.7165775401,0.7326203209,0.32,0.5989304813,20,25,20,25,5,0,0,0,2,1,1,137,187,137,187,50,1
588,619,32,34,0.8571428571,0.8857142857,2,33,0.9390243902,0.9512195122,0.4857142857,0.825203252,35,33,33,35,2,0,0,0,2,1,1,246,239,239,246,7,1
293,304,12,12,1,1,0,12,1,1,1,1,14,14,14,14,0,0,0,0,2,1,1,91,91,91,91,0,1
1401,1417,17,17,1,1,0,17,1,1,1,1,17,17,17,17,0,0,0,0,2,1,1,153,153,153,153,0,1
522,544,18,23,0.68,0.72,5,20.5,0.7165775401,0.7326203209,0.32,0.5989304813,20,25,20,25,5,0,0,0,2,1,1,137,187,137,187,50,1
135,182,48,55,0.8545454545,0.8727272727,7,51.5,0.9031339031,0.905982906,0.4909090909,0.7948717949,55,48,48,55,7,0,0,0,2,1,1,351,318,318,351,33,1
776,787,12,12,0.75,0.9166666667,0,12,0.8684210526,0.9298245614,0.4166666667,0.7807017544,12,12,12,12,0,0,0,0,2,1,1,114,108,108,114,6,1
55,69,15,15,0.9375,0.9375,0,15,0.9793103448,0.9931034483,0.9375,0.9931034483,16,16,16,16,0,0,0,0,2,1,1,145,145,145,145,0,1
382,392,11,14,0.5,0.7857142857,3,12.5,0.726618705,0.7553956835,0.2857142857,0.6402877698,14,11,11,14,3,0,0,0,2,1,1,139,105,105,139,34,1
16,39,19,24,0.6666666667,0.7083333333,5,21.5,0.7852760736,0.8220858896,0.1666666667,0.6134969325,19,24,19,24,5,0,0,0,2,1,1,137,163,137,163,26,1
280,289,10,10,1,1,0,10,1,1,1,1,11,11,11,11,0,0,0,0,2,1,1,131,131,131,131,0,1
306,344,39,39,0.8974358974,0.8974358974,0,39,0.9506578947,0.9506578947,0.4615384615,0.7105263158,39,39,39,39,0,0,0,0,2,1,1,304,297,297,304,7,1
648,665,18,18,1,1,0,18,1,1,1,1,20,20,20,20,0,0,0,0,2,1,1,137,137,137,137,0,1
168,184,17,17,0.7058823529,0.9411764706,0,17,0.9065934066,0.9285714286,0.2352941176,0.7527472527,17,17,17,17,0,0,0,0,2,1,1,176,182,176,182,6,1
258,264,7,7,0.75,1,0,7,0.9746835443,1,1,1,8,8,8,8,0,0,0,0,2,1,1,79,79,79,79,0,1
570,590,18,21,0.7391304348,0.7826086957,3,19.5,0.7951807229,0.813253012,0.347826087,0.656626506,20,23,20,23,3,0,0,0,2,1,1,137,166,137,166,29,1
335,349,15,15,1,1,0,15,1,1,1,1,15,15,15,15,0,0,0,0,2,1,1,117,117,117,117,0,1
408,422,13,15,0.4,0.8,2,14,0.6993464052,0.7908496732,0.2666666667,0.6535947712,13,15,13,15,2,0,0,0,2,1,1,121,153,121,153,32,1
248,261,14,14,0.8571428571,1,0,14,0.9880239521,1,1,1,14,14,14,14,0,0,0,0,2,1,1,167,167,167,167,0,1
278,291,14,14,0.6428571429,0.9285714286,0,14,0.84375,0.953125,0.9285714286,0.953125,14,14,14,14,0,0,0,0,2,1,1,64,61,61,64,3,1
280,289,10,10,1,1,0,10,1,1,1,1,11,11,11,11,0,0,0,0,2,1,1,131,131,131,131,0,1
402,431,30,30,1,1,0,30,1,1,1,1,30,30,30,30,0,0,0,0,2,1,1,210,210,210,210,0,1
444,473,30,30,1,1,0,30,1,1,1,1,30,30,30,30,0,0,0,0,2,1,1,210,210,210,210,0,1
369,379,11,12,0.75,0.9166666667,1,11.5,0.8728813559,0.8898305085,0.9166666667,0.8898305085,12,11,11,12,1,0,0,0,2,1,1,118,105,105,118,13,1
206,234,21,29,0.5862068966,0.6551724138,8,25,0.7222222222,0.7453703704,0.1724137931,0.5740740741,21,29,21,29,8,0,0,0,2,1,1,164,216,164,216,52,1
648,665,18,18,0.9,1,0,18,0.9854014599,1,1,1,20,20,20,20,0,0,0,0,2,1,1,137,137,137,137,0,1
595,605,10,11,0.7692307692,0.7692307692,1,10.5,0.8181818182,0.8282828283,0.2307692308,0.6262626263,12,13,12,13,1,0,0,0,2,1,1,83,99,83,99,16,1
593,610,18,18,0.9473684211,0.9473684211,0,18,0.9847328244,0.9847328244,0.9473684211,0.9847328244,19,19,19,19,0,4,4,8,2,1,1,131,129,129,131,2,1
126,138,13,13,1,1,0,13,1,1,1,1,13,13,13,13,0,0,0,0,2,1,1,111,111,111,111,0,1
73,85,13,13,1,1,0,13,1,1,1,1,14,14,14,14,0,0,0,0,2,1,1,160,160,160,160,0,1
955,967,12,13,0.5384615385,0.8461538462,1,12.5,0.7933884298,0.9256198347,0.3076923077,0.7272727273,12,13,12,13,1,0,0,0,2,1,1,118,121,118,121,3,1
238,250,12,13,0.5384615385,0.7692307692,1,12.5,0.7532467532,0.8181818182,0.4615384615,0.7662337662,12,13,12,13,1,0,0,0,2,1,1,126,154,126,154,28,1
381,392,12,12,1,1,0,12,1,1,1,1,14,14,14,14,0,0,0,0,2,1,1,124,124,124,124,0,1
1549,1565,17,17,1,1,0,17,1,1,1,1,17,17,17,17,0,0,0,0,2,1,1,142,142,142,142,0,1
631,650,20,20,0.8571428571,1,0,20,0.9806451613,1,1,1,21,21,21,21,0,1,1,2,4,2,2,155,155,155,155,0,1
264,274,11,12,0.5833333333,0.8333333333,1,11.5,0.8240740741,0.9351851852,0.3333333333,0.75,12,11,11,12,1,0,0,0,2,1,1,108,105,105,108,3,1
371,393,17,23,0.5652173913,0.5652173913,6,20,0.7096774194,0.7290322581,0.1304347826,0.5483870968,17,23,17,23,6,0,0,0,2,1,1,135,155,135,155,20,1
1195,1215,21,21,0.9523809524,0.9523809524,0,21,0.9296482412,0.9396984925,0.2857142857,0.6984924623,21,21,21,21,0,5,5,10,2,1,1,191,199,191,199,8,1
1006,1019,12,14,0.5,0.8571428571,2,13,0.85,0.8916666667,0.5714285714,0.8083333333,12,14,12,14,2,0,0,0,2,1,1,107,120,107,120,13,1
567,581,15,15,0.8666666667,1,0,15,0.9863945578,1,1,1,15,15,15,15,0,0,0,0,2,1,1,147,147,147,147,0,1
357,404,48,48,1,1,0,48,1,1,1,1,48,48,48,48,0,0,0,0,2,1,1,336,336,336,336,0,1
548,566,19,20,0.619047619,0.7142857143,1,19.5,0.6373626374,0.7417582418,0.2857142857,0.5989010989,21,20,20,21,1,0,0,0,2,1,1,182,169,169,182,13,1
347,357,11,11,0.5384615385,0.5384615385,0,11,0.7578947368,0.8105263158,0.3846153846,0.6315789474,13,13,13,13,0,0,0,0,2,1,1,95,91,91,95,4,1
450,460,11,11,1,1,0,11,1,1,1,1,11,11,11,11,0,2,2,4,2,1,1,103,103,103,103,0,1
573,587,15,15,1,1,0,15,1,1,1,1,15,15,15,15,0,0,0,0,2,1,1,147,147,147,147,0,1
258,267,10,12,0.1538461538,0.1538461538,2,11,0.2809917355,0.5371900826,0.1538461538,0.3719008264,13,11,11,13,2,0,0,0,2,1,1,121,94,94,121,27,0
440,452,13,14,0.7142857143,0.7857142857,1,13.5,0.8796992481,0.9172932331,0.5714285714,0.7969924812,14,13,13,14,1,0,0,0,2,1,1,128,133,128,133,5,1
570,590,21,23,0.84,0.88,2,22,0.8395721925,0.871657754,0.68,0.807486631,25,23,23,25,2,0,0,0,2,1,1,187,166,166,187,21,1
66,82,17,17,0.7368421053,1,0,17,0.9695121951,1,1,1,19,19,19,19,0,1,1,2,2,1,1,164,164,164,164,0,1
629,646,18,23,0.68,0.72,5,20.5,0.7165775401,0.7326203209,0.32,0.5989304813,25,20,20,25,5,0,0,0,2,1,1,187,137,137,187,50,1
73,96,24,24,1,1,0,24,1,1,1,1,24,24,24,24,0,1,1,2,2,1,1,189,189,189,189,0,1
110,197,88,88,1,1,0,88,1,1,1,1,88,88,88,88,0,0,0,0,2,1,1,484,484,484,484,0,1
433,480,48,48,1,1,0,48,1,1,1,1,48,48,48,48,0,0,0,0,2,1,1,336,336,336,336,0,1
2,22,21,21,0.6111111111,0.8888888889,0,21,0.850931677,0.8944099379,0.2777777778,0.6708074534,18,18,18,18,0,2,3,5,2,1,1,145,161,145,161,16,1
20,29,10,10,1,1,0,10,1,1,1,1,12,12,12,12,0,0,0,0,2,1,1,121,121,121,121,0,1
325,337,13,13,1,1,0,13,1,1,1,1,14,14,14,14,0,0,0,0,2,1,1,136,136,136,136,0,1
113,136,16,24,0.9333333333,0.9333333333,8,20,0.9655172414,0.9827586207,0.9333333333,0.974137931,15,15,15,15,0,1,1,2,4,2,2,114,116,114,116,2,1
1168,1196,29,29,0.3793103448,0.3793103448,0,29,0.7303370787,0.7303370787,0.3448275862,0.5842696629,29,29,29,29,0,0,0,0,2,1,1,267,195,195,267,72,1
394,405,12,13,0.5384615385,0.9230769231,1,12.5,0.8429752066,0.8842975207,0.9230769231,0.8842975207,13,12,12,13,1,0,0,0,2,1,1,121,107,107,121,14,1
954,986,33,34,0.7941176471,0.8823529412,1,33.5,0.8791946309,0.9395973154,0.3235294118,0.6879194631,34,33,33,34,1,0,0,0,2,1,1,298,287,287,298,11,1
320,331,12,14,0.5714285714,0.8571428571,2,13,0.7967479675,0.8699186992,0.3571428571,0.7154471545,14,12,12,14,2,0,0,0,2,1,1,123,107,107,123,16,1
115,122,8,8,0.625,1,0,8,0.9411764706,1,1,1,8,8,8,8,0,1,1,2,2,1,1,51,51,51,51,0,1
73,82,10,10,1,1,0,10,1,1,1,1,10,10,10,10,0,0,0,0,2,1,1,62,62,62,62,0,1
204,220,17,17,1,1,0,17,1,1,1,1,15,15,15,15,0,3,3,6,6,3,3,126,126,126,126,0,1
285,291,7,7,1,1,0,7,1,1,1,1,7,7,7,7,0,0,0,0,2,1,1,32,32,32,32,0,1
369,458,90,90,1,1,0,90,1,1,1,1,60,60,60,60,0,1,1,2,4,2,2,317,317,317,317,0,1
583,590,8,8,0.8888888889,1,0,8,0.9807692308,1,1,1,9,9,9,9,0,1,1,2,2,1,1,52,52,52,52,0,1
293,299,7,7,0.3333333333,0.8333333333,0,7,0.7457627119,0.9152542373,0.8333333333,0.8983050847,6,6,6,6,0,1,1,2,4,2,2,59,54,54,59,5,1
183,193,11,11,1,1,0,11,1,1,1,1,11,11,11,11,0,0,0,0,2,1,1,115,115,115,115,0,1
73,85,13,13,1,1,0,13,1,1,1,1,14,14,14,14,0,0,0,0,2,1,1,160,160,160,160,0,1
46,66,21,21,1,1,0,21,1,1,1,1,19,19,19,19,0,1,1,2,4,2,2,169,169,169,169,0,1
546,568,23,23,1,1,0,23,1,1,1,1,25,25,25,25,0,0,0,0,2,1,1,187,187,187,187,0,1
653,658,6,6,1,1,0,6,1,1,1,1,8,8,8,8,0,2,2,4,2,1,1,85,85,85,85,0,1
43,52,10,10,1,1,0,10,1,1,1,1,10,10,10,10,0,0,0,0,2,1,1,88,88,88,88,0,1
495,501,7,7,1,1,0,7,1,1,1,1,7,7,7,7,0,0,0,0,2,1,1,51,51,51,51,0,1
750,759,10,10,0.7,1,0,10,0.9734513274,1,1,1,10,10,10,10,0,1,1,2,2,1,1,113,113,113,113,0,1
322,360,39,39,0.9487179487,0.9487179487,0,39,0.9730639731,0.9730639731,0.8205128205,0.9562289562,39,39,39,39,0,0,0,0,2,1,1,297,296,296,297,1,1
73,82,8,10,0.6,0.7,2,9,0.9032258065,0.9193548387,0.7,0.9193548387,9,10,9,10,1,0,0,0,2,1,1,62,62,62,62,0,1
615,620,6,6,0.8333333333,1,0,6,0.9857142857,1,1,1,6,6,6,6,0,1,1,2,2,1,1,70,70,70,70,0,1
508,512,5,5,0.6,1,0,5,0.9615384615,1,1,1,5,5,5,5,0,1,1,2,2,1,1,52,52,52,52,0,1
331,350,20,20,1,1,0,20,1,1,1,1,23,23,23,23,0,0,0,0,2,1,1,269,269,269,269,0,1
21,29,9,9,0.6666666667,0.8888888889,0,9,0.9324324324,0.972972973,0.7777777778,0.9594594595,9,9,9,9,0,0,0,0,2,1,1,72,74,72,74,2,1
140,155,12,16,0.9090909091,1,4,14,0.9880952381,1,1,1,11,11,11,11,0,1,1,2,2,1,1,84,84,84,84,0,1
190,195,6,6,0.7142857143,0.8571428571,0,6,0.8405797101,0.884057971,0.2857142857,0.6231884058,7,7,7,7,0,1,1,2,2,1,1,69,61,61,69,8,1
1034,1039,6,6,0.8,1,0,6,0.9791666667,1,1,1,5,5,5,5,0,1,1,2,2,1,1,48,48,48,48,0,1
297,306,10,10,1,1,0,10,1,1,1,1,10,10,10,10,0,0,0,0,2,1,1,77,77,77,77,0,1
331,335,5,5,0.5714285714,0.7142857143,0,5,0.7125,0.7375,0.7142857143,0.725,6,7,6,7,1,0,1,1,2,1,1,60,80,60,80,20,1
200,214,15,15,1,1,0,15,1,1,1,1,15,15,15,15,0,0,0,0,2,1,1,67,67,67,67,0,1
203,208,6,6,0.8571428571,1,0,6,0.9836065574,1,1,1,7,7,7,7,0,1,1,2,2,1,1,61,61,61,61,0,1
125,143,19,19,0.9,0.9,0,19,0.9907834101,0.9907834101,0.9,0.9907834101,20,20,20,20,0,0,0,0,2,1,1,217,217,217,217,0,1
64,69,6,6,1,1,0,6,1,1,1,1,6,6,6,6,0,3,3,6,2,1,1,56,56,56,56,0,1
662,667,6,6,0.6666666667,1,0,6,0.9649122807,1,1,1,6,6,6,6,0,1,1,2,2,1,1,57,57,57,57,0,1
566,570,5,5,1,1,0,5,1,1,1,1,7,7,7,7,0,2,2,4,2,1,1,59,59,59,59,0,1
132,140,9,9,1,1,0,9,1,1,1,1,11,11,11,11,0,0,0,0,2,1,1,129,129,129,129,0,1
136,145,10,10,0.7,0.8,0,10,0.8679245283,0.8867924528,0.2,0.7735849057,10,10,10,10,0,0,0,0,2,1,1,106,95,95,106,11,1
1444,1453,10,10,0.4545454545,0.9090909091,0,10,0.7281553398,0.9029126214,0.9090909091,0.8932038835,11,11,11,11,0,0,0,0,2,1,1,103,96,96,103,7,1
382,388,7,7,0,1,0,7,0.5714285714,1,1,1,7,7,7,7,0,0,0,0,2,1,1,49,49,49,49,0,0
308,322,15,15,1,1,0,15,1,1,1,1,15,15,15,15,0,0,0,0,2,1,1,162,162,162,162,0,1
490,495,6,6,0.5714285714,0.5714285714,0,6,0.7126436782,0.7471264368,0.1428571429,0.632183908,7,7,7,7,0,2,2,4,2,1,1,87,73,73,87,14,1
345,349,5,5,0.6666666667,1,0,5,0.9677419355,1,1,1,6,6,6,6,0,2,2,4,2,1,1,62,62,62,62,0,1
352,359,8,8,0.25,0.875,0,8,0.6901408451,0.9436619718,0.875,0.9436619718,8,8,8,8,0,0,0,0,2,1,1,67,71,67,71,4,1
256,270,15,15,0.5333333333,0.5333333333,0,15,0.9173553719,0.9173553719,0.2666666667,0.8595041322,15,15,15,15,0,0,0,0,2,1,1,117,121,117,121,4,1
1128,1141,12,14,0.5714285714,0.7857142857,2,13,0.8017241379,0.8620689655,0.7142857143,0.8275862069,12,14,12,14,2,0,0,0,2,1,1,101,116,101,116,15,1
6,18,13,13,1,1,0,13,1,1,1,1,13,13,13,13,0,0,0,0,2,1,1,138,138,138,138,0,1
349,352,3,4,0,0,1,3.5,0.4333333333,0.6833333333,0,0.5833333333,3,4,3,4,1,1,0,1,2,1,1,60,57,57,60,3,0
54,62,9,10,0.6,0.7,1,9.5,0.8548387097,0.8709677419,0.7,0.8709677419,10,9,9,10,1,0,0,0,2,1,1,62,62,62,62,0,1
64,71,8,9,0.5555555556,0.6666666667,1,8.5,0.8387096774,0.8548387097,0.6666666667,0.8548387097,9,9,9,9,0,0,0,0,2,1,1,62,62,62,62,0,1
49,61,5,13,0,0,8,9,0.3684210526,0.6578947368,0,0.5526315789,4,3,3,4,1,1,1,2,0,0,0,27,38,27,38,11,0
71,80,10,10,0.5454545455,1,0,10,0.9130434783,1,0.9090909091,0.9826086957,11,11,11,11,0,0,0,0,2,1,1,115,115,115,115,0,1
1068,1074,6,7,0.2857142857,0.7142857143,1,6.5,0.4285714286,0.5714285714,0.7142857143,0.5714285714,6,7,6,7,1,0,0,0,2,1,1,26,42,26,42,16,0
206,228,14,23,0,0.1578947368,9,18.5,0.2298850575,0.4252873563,0,0.2873563218,9,19,9,19,10,1,2,3,3,1,2,53,87,53,87,34,0
38,43,6,6,0.6666666667,0.8333333333,0,6,0.8888888889,0.962962963,0.8333333333,0.962962963,6,6,6,6,0,0,0,0,2,1,1,26,27,26,27,1,1
290,306,16,17,0.3529411765,0.9411764706,1,16.5,0.8483146067,0.9606741573,0.7058823529,0.9269662921,16,17,16,17,1,0,0,0,2,1,1,171,178,171,178,7,1
680,706,27,27,1,1,0,27,1,1,1,1,27,27,27,27,0,0,0,0,2,1,1,158,158,158,158,0,1
25,37,13,13,0.5384615385,1,0,13,0.9323308271,1,1,1,13,13,13,13,0,0,0,0,2,1,1,133,133,133,133,0,1
583,590,8,8,0.8888888889,1,0,8,0.9807692308,1,1,1,9,9,9,9,0,1,1,2,2,1,1,52,52,52,52,0,1
54,62,9,9,1,1,0,9,1,1,1,1,9,9,9,9,0,0,0,0,2,1,1,62,62,62,62,0,1
209,217,9,9,0.7777777778,1,0,9,0.975,1,1,1,9,9,9,9,0,0,0,0,2,1,1,80,80,80,80,0,1
49,57,8,9,0.5555555556,0.7777777778,1,8.5,0.5744680851,0.6808510638,0.3333333333,0.5106382979,8,9,8,9,1,0,0,0,2,1,1,34,47,34,47,13,0
45,69,9,25,0,0,16,17,0.3880597015,0.7014925373,0,0.5373134328,7,5,5,7,2,1,1,2,0,0,0,67,63,63,67,4,0
68,76,9,9,0.7,1,0,9,0.9659090909,1,1,1,10,10,10,10,0,1,1,2,2,1,1,88,88,88,88,0,1
115,115,1,1,0,1,0,1,0.9925373134,1,1,1,1,1,1,1,0,0,0,0,2,1,1,134,134,134,134,0,1
140,152,9,13,0.5384615385,0.6923076923,4,11,0.6966292135,0.7191011236,0.6153846154,0.6966292135,9,13,9,13,4,0,0,0,2,1,1,64,89,64,89,25,1
61,66,6,6,0.3333333333,0.8333333333,0,6,0.6551724138,0.8965517241,0.8333333333,0.8965517241,6,6,6,6,0,0,0,0,2,1,1,27,29,27,29,2,0
748,756,9,9,0.6666666667,0.8888888889,0,9,0.9396551724,0.974137931,0,0.8965517241,9,9,9,9,0,0,0,0,2,1,1,116,115,115,116,1,1
358,365,8,8,1,1,0,8,1,1,1,1,8,8,8,8,0,0,0,0,2,1,1,51,51,51,51,0,1
161,168,8,9,0,0.2222222222,1,8.5,0.3333333333,0.5873015873,0,0.4444444444,9,8,8,9,1,1,1,2,2,1,1,59,63,59,63,4,0
37,40,4,4,0,1,0,4,0.8125,1,1,1,4,4,4,4,0,0,0,0,2,1,1,64,64,64,64,0,0
848,988,141,141,0,1,0,141,0.5714285714,1,1,1,141,141,141,141,0,0,0,0,2,1,1,987,987,987,987,0,0
1403,1432,30,30,0,0,0,30,0.4285714286,0.6428571429,0,0.6428571429,30,30,30,30,0,0,0,0,2,1,1,150,210,150,210,60,0
41,47,7,8,0.5,0.625,1,7.5,0.4782608696,0.6304347826,0.5,0.4782608696,8,7,7,8,1,0,0,0,3,2,1,46,35,35,46,11,0
64,71,8,11,0.4545454545,0.4545454545,3,9.5,0.4920634921,0.6031746032,0.1818181818,0.4126984127,11,8,8,11,3,0,0,0,2,1,1,63,59,59,63,4,0
7,19,13,22,0,0.3333333333,9,17.5,0.4857142857,0.7714285714,0,0.5,9,9,9,9,0,1,1,2,0,0,0,64,70,64,70,6,0
8,30,23,124,0,0.2222222222,101,73.5,0.3561643836,0.5753424658,0,0.4246575342,7,9,7,9,2,1,3,4,1,0,1,57,73,57,73,16,0
270,275,5,6,0.1666666667,0.6666666667,1,5.5,0.8939393939,0.9545454545,0.6666666667,0.9545454545,5,6,5,6,1,0,1,1,3,1,2,65,66,65,66,1,0
394,404,11,15,0.4375,0.5,4,13,0.8034682081,0.8554913295,0.125,0.6589595376,16,12,12,16,4,0,0,0,2,1,1,173,159,159,173,14,0
113,119,7,10,0.1,0.1,3,8.5,0.3870967742,0.5806451613,0.1,0.4516129032,10,7,7,10,3,1,0,1,2,1,1,62,56,56,62,6,0
686,690,5,5,0,0.8,0,5,0.7213114754,0.9672131148,0.8,0.9672131148,5,5,5,5,0,0,1,1,2,1,1,61,59,59,61,2,0
23,64,42,42,1,1,0,42,1,1,1,1,39,39,39,39,0,0,0,0,0,0,0,397,397,397,397,0,1
166,171,6,7,0.1428571429,0.7142857143,1,6.5,0.5319148936,0.829787234,0.1428571429,0.7021276596,7,6,6,7,1,0,0,0,2,1,1,47,41,41,47,6,0
604,617,14,14,1,1,0,14,1,1,1,1,15,15,15,15,0,0,0,0,2,1,1,131,131,131,131,0,1
522,544,21,23,0.84,0.88,2,22,0.8395721925,0.871657754,0.68,0.807486631,23,25,23,25,2,0,0,0,2,1,1,166,187,166,187,21,1
144,148,5,5,0.6,0.6,0,5,0.7173913043,0.7391304348,0,0.5,5,5,5,5,0,1,1,2,2,1,1,68,92,68,92,24,1
798,847,39,50,0.68,0.72,11,44.5,0.9179104478,0.9291044776,0.72,0.9291044776,40,50,40,50,10,0,0,0,2,1,1,249,268,249,268,19,1
116,122,7,7,0.4285714286,0.7142857143,0,7,0.5757575758,0.7272727273,0.4285714286,0.6060606061,7,7,7,7,0,0,0,0,3,1,2,33,26,26,33,7,0
316,328,13,13,1,1,0,13,1,1,1,1,13,13,13,13,0,0,0,0,2,1,1,98,98,98,98,0,0
147,192,46,46,0,0,0,46,0.4444444444,0.7777777778,0,0.7777777778,46,46,46,46,0,0,0,0,2,1,1,322,414,322,414,92,0
76,82,6,7,0,0,1,6.5,0.34375,0.625,0,0.421875,7,7,7,7,0,1,0,1,2,1,1,64,63,63,64,1,0
1375,1385,11,11,0,1,0,11,0.5714285714,1,1,1,11,11,11,11,0,0,0,0,2,1,1,77,77,77,77,0,0
44,48,5,7,0,0,2,6,0.328125,0.53125,0,0.390625,7,5,5,7,2,1,0,1,2,1,1,60,64,60,64,4,0
218,223,6,11,0,0,5,8.5,0.3150684932,0.5205479452,0,0.3698630137,12,6,6,12,6,4,0,4,2,1,1,73,53,53,73,20,0
73,79,6,7,0.2857142857,0.4285714286,1,6.5,0.6891891892,0.8108108108,0.2857142857,0.7027027027,6,7,6,7,1,0,0,0,2,1,1,64,74,64,74,10,0
124,131,8,8,1,1,0,8,1,1,1,1,8,8,8,8,0,0,0,0,2,1,1,53,53,53,53,0,1
305,317,13,13,0.0909090909,0.1818181818,0,13,0.28,0.4666666667,0.0909090909,0.3733333333,7,11,7,11,4,0,2,2,4,2,2,59,75,59,75,16,0
181,189,9,10,0.5833333333,0.6666666667,1,9.5,0.7325581395,0.7790697674,0.25,0.5813953488,12,11,11,12,1,0,0,0,2,1,1,86,78,78,86,8,0
351,368,3,18,0,0.0769230769,15,10.5,0.2365591398,0.4086021505,0,0.2795698925,4,13,4,13,9,0,0,0,3,1,2,53,93,53,93,40,0
144,174,10,31,0.1290322581,0.1935483871,21,20.5,0.1292517007,0.1870748299,0.1290322581,0.1428571429,10,31,10,31,21,0,0,0,2,1,1,67,294,67,294,227,0
72,74,3,3,0,0.6666666667,0,3,0.75,0.9230769231,0.6666666667,0.9038461538,3,3,3,3,0,0,0,0,2,1,1,52,48,48,52,4,0
112,121,9,10,0.1,0.3,1,9.5,0.4487179487,0.6794871795,0.2,0.5128205128,9,10,9,10,1,0,1,1,2,1,1,56,78,56,78,22,0
525,526,2,3,0,0.6666666667,1,2.5,0.6396396396,0.6666666667,0.6666666667,0.6666666667,3,2,2,3,1,0,0,0,2,1,1,111,74,74,111,37,0
649,654,6,7,0,0.4285714286,1,6.5,0.7441860465,0.9302325581,0.2857142857,0.8139534884,7,6,6,7,1,1,0,1,2,1,1,43,42,42,43,1,0
777,784,7,8,0.125,0.75,1,7.5,0.5510204082,0.8775510204,0.25,0.7959183673,7,8,7,8,1,0,0,0,2,1,1,44,49,44,49,5,0
529,543,15,15,0.4666666667,0.7333333333,0,15,0.7844311377,0.8982035928,0.1333333333,0.6347305389,15,15,15,15,0,0,0,0,2,1,1,167,155,155,167,12,0
498,557,54,60,0.8245614035,0.8245614035,6,57,0.9751552795,0.9751552795,0.8245614035,0.9751552795,53,57,53,57,4,3,3,6,4,2,2,315,322,315,322,7,0
681,722,42,58,0.9696969697,0.9696969697,16,50,0.970212766,0.9829787234,0.9696969697,0.9787234043,33,33,33,33,0,1,1,2,4,2,2,235,234,234,235,1,0
516,519,4,4,0,0.4,0,4,0.3147826087,0.36,0,0.2434782609,4,5,4,5,1,0,1,1,2,1,1,575,209,209,575,366,0
650,667,18,23,0.68,0.72,5,20.5,0.7165775401,0.7326203209,0.32,0.5989304813,25,20,20,25,5,0,0,0,2,1,1,187,137,137,187,50,0
136,145,10,10,0.5,0.5,0,10,0.7311827957,0.7956989247,0.4,0.6989247312,10,10,10,10,0,0,0,0,2,1,1,86,93,86,93,7,0
126,133,8,8,1,1,0,8,1,1,1,1,8,8,8,8,0,0,0,0,2,1,1,71,71,71,71,0,1
81,87,7,7,0.5714285714,0.7142857143,0,7,0.6333333333,0.7666666667,0.5714285714,0.6666666667,7,7,7,7,0,0,0,0,4,2,2,30,28,28,30,2,0
33,42,10,11,0.2727272727,0.8181818182,1,10.5,0.7356321839,0.8850574713,0.3636363636,0.7471264368,11,10,10,11,1,0,0,0,2,1,1,87,78,78,87,9,1
216,230,15,15,1,1,0,15,1,1,1,1,15,15,15,15,0,0,0,0,2,1,1,67,67,67,67,0,1
522,544,18,23,0.68,0.72,5,20.5,0.7165775401,0.7326203209,0.32,0.5989304813,20,25,20,25,5,0,0,0,2,1,1,137,187,137,187,50,0
545,557,13,15,0.4666666667,0.8,2,14,0.7588652482,0.8226950355,0.3333333333,0.6879432624,15,13,13,15,2,0,0,0,2,1,1,141,116,116,141,25,0
115,130,13,16,0.4375,0.8125,3,14.5,0.7142857143,0.751552795,0.5625,0.7391304348,13,16,13,16,3,0,0,0,2,1,1,121,161,121,161,40,0
1074,1079,6,6,0,0.8333333333,0,6,0.5714285714,0.9761904762,0,0.6904761905,6,6,6,6,0,0,0,0,2,1,1,42,42,42,42,0,0
609,614,6,6,0.1428571429,0.1428571429,0,6,0.359375,0.453125,0.1428571429,0.34375,6,7,6,7,1,0,1,1,2,1,1,51,64,51,64,13,0
409,422,13,14,0.2857142857,0.3571428571,1,13.5,0.3698630137,0.5479452055,0.2857142857,0.4109589041,13,14,13,14,1,0,0,0,2,1,1,62,73,62,73,11,0
818,845,28,28,0,0,0,28,0.2222222222,0.3888888889,0,0.3333333333,28,28,28,28,0,0,0,0,2,1,1,504,252,252,504,252,0
573,594,22,22,0.7857142857,0.9285714286,0,22,0.9791666667,0.9930555556,0.9285714286,0.9930555556,14,14,14,14,0,1,1,2,4,2,2,143,144,143,144,1,0
428,443,16,17,0.1666666667,0.2222222222,1,16.5,0.3012048193,0.5240963855,0.1666666667,0.3674698795,18,16,16,18,2,0,0,0,2,1,1,138,166,138,166,28,0
407,422,14,16,0.4375,0.8125,2,15,0.7032258065,0.7935483871,0.3125,0.6580645161,14,16,14,16,2,0,0,0,2,1,1,123,155,123,155,32,0
1,9,8,9,0.5,0.875,1,8.5,0.8392857143,0.9464285714,0,0.6071428571,8,8,8,8,0,0,0,0,0,0,0,56,54,54,56,2,0
403,412,10,11,0.4545454545,0.4545454545,1,10.5,0.552238806,0.552238806,0.2727272727,0.4626865672,11,10,10,11,1,1,1,2,2,1,1,67,63,63,67,4,0
59,72,14,14,0.2142857143,0.2142857143,0,14,0.3406593407,0.6153846154,0.2142857143,0.4835164835,14,14,14,14,0,0,0,0,2,1,1,91,82,82,91,9,0
335,342,8,12,0.2727272727,0.2727272727,4,10,0.4,0.64,0.2727272727,0.5066666667,11,9,9,11,2,1,0,1,3,2,1,75,73,73,75,2,0
132,182,51,51,1,1,0,51,1,1,1,1,48,48,48,48,0,1,1,2,4,2,2,322,322,322,322,0,0
52,62,11,11,0.3636363636,0.7272727273,0,11,0.515625,0.65625,0.4545454545,0.53125,11,11,11,11,0,0,0,0,2,1,1,64,48,48,64,16,0
426,457,32,32,1,1,0,32,1,1,1,1,32,32,32,32,0,0,0,0,2,1,1,224,224,224,224,0,0
624,634,10,11,0.4545454545,0.7272727273,1,10.5,0.4833333333,0.6333333333,0.4545454545,0.5,10,11,10,11,1,0,0,0,6,4,2,55,60,55,60,5,0
47,68,22,22,1,1,0,22,1,1,1,1,23,23,23,23,0,1,1,2,2,1,1,176,176,176,176,0,0
52,90,39,39,1,1,0,39,1,1,1,1,20,20,20,20,0,1,1,2,0,0,0,185,185,185,185,0,0
906,916,11,11,0.9090909091,1,0,11,0.9915966387,1,1,1,11,11,11,11,0,0,0,0,2,1,1,119,119,119,119,0,0
162,211,50,65,1,1,15,57.5,1,1,1,1,50,50,50,50,0,1,1,2,4,2,2,379,379,379,379,0,0
114,136,23,25,0.2,0.2,2,24,0.3375796178,0.5414012739,0.2,0.4331210191,25,23,23,25,2,0,0,0,2,1,1,157,139,139,157,18,0
200,216,17,20,0.2,0.2,3,18.5,0.4609929078,0.6241134752,0.2,0.4539007092,20,17,17,20,3,0,0,0,2,1,1,141,116,116,141,25,0
8,28,21,30,0.1333333333,0.2333333333,9,25.5,0.3708920188,0.5211267606,0.1333333333,0.3521126761,30,21,21,30,9,0,0,0,2,1,1,213,156,156,213,57,0
168,184,15,17,0.4117647059,0.6470588235,2,16,0.8076923077,0.8901098901,0.1176470588,0.6428571429,15,17,15,17,2,0,0,0,2,1,1,167,182,167,182,15,0
136,152,17,17,0.5263157895,0.9473684211,0,17,0.9248554913,0.9884393064,0.9473684211,0.9884393064,19,19,19,19,0,1,1,2,2,1,1,173,173,173,173,0,0
855,888,29,34,0.1470588235,0.1764705882,5,31.5,0.2836879433,0.4680851064,0.1470588235,0.3226950355,29,34,29,34,5,0,0,0,2,1,1,176,282,176,282,106,0
234,245,12,13,0.5384615385,0.8461538462,1,12.5,0.7933884298,0.9256198347,0.3076923077,0.7272727273,13,12,12,13,1,0,0,0,2,1,1,121,118,118,121,3,0
408,422,15,15,1,1,0,15,1,1,1,1,15,15,15,15,0,0,0,0,2,1,1,153,153,153,153,0,1
211,414,204,204,1,1,0,204,1,1,1,1,161,161,161,161,0,0,0,0,4,2,2,1603,1603,1603,1603,0,0
110,119,10,19,0.15,0.25,9,14.5,0.2,0.3142857143,0.15,0.2285714286,20,10,10,20,10,0,0,0,2,1,1,140,51,51,140,89,0
457,478,22,22,0,0,0,22,0.4285714286,0.5714285714,0,0.4415584416,22,22,22,22,0,0,0,0,2,1,1,110,154,110,154,44,0
392,403,11,12,0.25,0.3333333333,1,11.5,0.3365384615,0.5480769231,0.25,0.4038461538,11,12,11,12,1,0,0,0,2,1,1,70,104,70,104,34,0
856,886,25,31,0.1935483871,0.3870967742,6,28,0.4339622642,0.6163522013,0.1935483871,0.4779874214,25,31,25,31,6,0,0,0,2,1,1,148,159,148,159,11,0
170,196,27,30,0.0666666667,0.2,3,28.5,0.418699187,0.6666666667,0.0666666667,0.4634146341,30,28,28,30,2,0,0,0,2,1,1,246,241,241,246,5,0
171,201,31,31,1,1,0,31,1,1,1,1,29,29,29,29,0,1,1,2,4,2,2,210,210,210,210,0,0
13,123,111,116,0.9473684211,0.9473684211,5,113.5,0.9444444444,0.9555555556,0.1052631579,0.6555555556,38,38,38,38,0,2,2,4,2,1,1,263,270,263,270,7,0
955,967,13,14,0.4285714286,0.8571428571,1,13.5,0.7482014388,0.8705035971,0.2857142857,0.7050359712,14,13,13,14,1,0,0,0,2,1,1,139,121,121,139,18,0
289,298,10,10,0.3,0.6,0,10,0.54,0.78,0.4,0.64,10,10,10,10,0,0,0,0,2,1,1,50,48,48,50,2,0
227,238,12,16,0.1875,0.1875,4,14,0.3789473684,0.5157894737,0.1875,0.4,16,12,12,16,4,0,0,0,2,1,1,95,71,71,95,24,0
118,131,14,15,0.2666666667,0.3333333333,1,14.5,0.419047619,0.5904761905,0.2666666667,0.4476190476,15,14,14,15,1,0,0,0,2,1,1,105,85,85,105,20,0
136,136,1,1,0,1,0,1,0.8151515152,1,1,1,1,1,1,1,0,0,0,0,0,0,0,330,330,330,330,0,0
169,182,12,14,0.2,0.2,2,13,0.2857142857,0.5210084034,0.2,0.3445378151,12,15,12,15,3,0,0,0,2,1,1,119,103,103,119,16,0
345,361,17,17,1,1,0,17,1,1,1,1,17,17,17,17,0,0,0,0,2,1,1,119,119,119,119,0,0
10,221,1,212,0.0384615385,0.0384615385,211,106.5,0.9333036905,0.9333036905,0.0384615385,0.9333036905,1,26,1,26,25,0,1,1,0,0,0,2099,2249,2099,2249,150,0
322,341,20,20,0.95,0.95,0,20,0.9655172414,0.9753694581,0.1,0.7487684729,20,20,20,20,0,1,1,2,2,1,1,203,198,198,203,5,0
10,10,1,1547,0.0357142857,0.0357142857,1546,774,0.9316466933,0.9316466933,0.0357142857,0.9316466933,28,1,1,28,27,1,0,1,0,0,0,2253,2099,2099,2253,154,0
10,10,1,212,0.0357142857,0.0357142857,211,106.5,0.9316466933,0.9316466933,0.0357142857,0.9316466933,28,1,1,28,27,1,0,1,0,0,0,2253,2099,2099,2253,154,0
744,759,13,16,0.5,0.8125,3,14.5,0.7055214724,0.7423312883,0.6875,0.736196319,13,16,13,16,3,0,0,0,2,1,1,121,163,121,163,42,0
524,546,18,23,0.68,0.72,5,20.5,0.7165775401,0.7326203209,0.32,0.5989304813,20,25,20,25,5,0,0,0,2,1,1,137,187,137,187,50,0
612,633,22,22,0.8181818182,0.9545454545,0,22,0.9634703196,0.9863013699,0.9545454545,0.9863013699,22,22,22,22,0,0,1,1,2,1,1,219,218,218,219,1,0
48,98,51,51,1,1,0,51,1,1,1,1,26,26,26,26,0,1,1,2,0,0,0,228,228,228,228,0,0
458,479,22,22,1,1,0,22,1,1,1,1,22,22,22,22,0,0,0,0,2,1,1,154,154,154,154,0,0
24,69,46,46,1,1,0,46,1,1,1,1,40,40,40,40,0,0,0,0,0,0,0,276,276,276,276,0,1
633,649,17,17,1,1,0,17,1,1,1,1,17,17,17,17,0,0,0,0,2,1,1,100,100,100,100,0,1
469,490,22,22,1,1,0,22,1,1,1,1,22,22,22,22,0,0,0,0,2,1,1,154,154,154,154,0,0
24,69,46,46,1,1,0,46,1,1,1,1,40,40,40,40,0,0,0,0,0,0,0,276,276,276,276,0,1
10,1554,1,1545,0.0384615385,0.0384615385,1544,773,0.9333036905,0.9333036905,0.0384615385,0.9333036905,1,26,1,26,25,0,1,1,0,0,0,2099,2249,2099,2249,150,0
10,233,1,224,0.0384615385,0.0384615385,223,112.5,0.9333036905,0.9333036905,0.0384615385,0.9333036905,1,26,1,26,25,0,1,1,0,0,0,2099,2249,2099,2249,150,0
453,484,32,32,0,0,0,32,0.4285714286,0.5714285714,0,0.4375,32,32,32,32,0,0,0,0,2,1,1,160,224,160,224,64,0
329,342,14,14,0.8,0.9333333333,0,14,0.96875,0.984375,0.9333333333,0.984375,15,15,15,15,0,1,1,2,2,1,1,128,126,126,128,2,0
10,224,1,215,0.0384615385,0.0384615385,214,108,0.9333036905,0.9333036905,0.0384615385,0.9333036905,1,26,1,26,25,0,1,1,0,0,0,2099,2249,2099,2249,150,0
354,384,31,31,1,1,0,31,1,1,1,1,31,31,31,31,0,0,0,0,2,1,1,217,217,217,217,0,0
10,10,1,106,0.0357142857,0.0357142857,105,53.5,0.9316466933,0.9316466933,0.0357142857,0.9316466933,28,1,1,28,27,1,0,1,0,0,0,2253,2099,2099,2253,154,0
10,1554,1,1545,0.0357142857,0.0357142857,1544,773,0.9316466933,0.9316466933,0.0357142857,0.9316466933,1,28,1,28,27,0,1,1,0,0,0,2099,2253,2099,2253,154,0
364,373,10,10,0.4,0.5,0,10,0.4590163934,0.6229508197,0.4,0.5245901639,10,10,10,10,0,0,0,0,3,2,1,61,50,50,61,11,0
560,571,12,14,0.4285714286,0.7857142857,2,13,0.7006802721,0.7755102041,0.2857142857,0.6462585034,14,12,12,14,2,0,0,0,2,1,1,147,114,114,147,33,0
158,167,10,10,0.5,1,0,10,0.9230769231,1,1,1,10,10,10,10,0,0,0,0,2,1,1,65,65,65,65,0,0
380,396,17,17,1,1,0,17,1,1,1,1,17,17,17,17,0,0,0,0,2,1,1,119,119,119,119,0,0
26,38,13,13,0.2142857143,0.2857142857,0,13,0.3673469388,0.5612244898,0.2142857143,0.4591836735,13,14,13,14,1,0,0,0,2,1,1,81,98,81,98,17,0
335,344,10,10,0.3,0.6,0,10,0.4426229508,0.6557377049,0.3,0.5081967213,10,10,10,10,0,0,0,0,3,1,2,61,59,59,61,2,0
580,604,25,26,0.1538461538,0.2307692308,1,25.5,0.324,0.528,0.1538461538,0.356,26,25,25,26,1,0,0,0,2,1,1,250,177,177,250,73,0
18,275,258,258,1,1,0,258,1,1,1,1,225,225,225,225,0,0,0,0,0,0,0,1865,1865,1865,1865,0,0
228,244,17,17,0.5263157895,0.9473684211,0,17,0.8736263736,0.956043956,0.9473684211,0.9505494505,19,19,19,19,0,0,1,1,2,1,1,176,182,176,182,6,0
321,336,16,17,0.5294117647,0.8235294118,1,16.5,0.7906976744,0.8720930233,0.3529411765,0.7325581395,17,16,16,17,1,0,0,0,2,1,1,86,82,82,86,4,0
673,682,10,12,0.7142857143,0.7142857143,2,11,0.7428571429,0.780952381,0.2142857143,0.5904761905,14,12,12,14,2,0,0,0,2,1,1,105,86,86,105,19,0
86,112,27,27,0.962962963,0.962962963,0,27,0.9553072626,0.9664804469,0.5185185185,0.7597765363,27,27,27,27,0,4,4,8,2,1,1,179,173,173,179,6,0
507,526,18,20,0.45,0.8,2,19,0.7466063348,0.8190045249,0.2,0.6742081448,18,20,18,20,2,0,0,0,2,1,1,183,221,183,221,38,0
384,408,25,25,0.9166666667,0.9166666667,0,25,0.8486842105,0.8684210526,0.7916666667,0.8289473684,24,24,24,24,0,0,0,0,4,2,2,152,138,138,152,14,0
1532,1546,15,15,0.6666666667,0.8666666667,0,15,0.8489208633,0.928057554,0.7333333333,0.8633093525,15,15,15,15,0,0,0,0,2,1,1,139,129,129,139,10,0
146,176,31,35,0.2,0.7142857143,4,33,0.4779874214,0.7169811321,0.4571428571,0.5534591195,35,31,31,35,4,0,0,0,2,1,1,136,159,136,159,23,0
64,76,13,13,1,1,0,13,1,1,1,1,13,13,13,13,0,0,0,0,2,1,1,108,108,108,108,0,0
202,350,149,149,0.9826086957,0.9826086957,0,149,0.9722497522,0.9722497522,0.3391304348,0.7502477701,115,115,115,115,0,1,1,2,2,1,1,981,1009,981,1009,28,0
433,443,11,11,1,1,0,11,1,1,1,1,11,11,11,11,0,1,1,2,2,1,1,107,107,107,107,0,0
90,138,49,49,0.7636363636,1,0,49,0.9728033473,1,1,1,55,55,55,55,0,1,1,2,2,1,1,478,478,478,478,0,1
327,358,32,32,1,1,0,32,1,1,1,1,32,32,32,32,0,0,0,0,2,1,1,224,224,224,224,0,0
670,683,13,14,0.4285714286,0.7857142857,1,13.5,0.7278911565,0.8231292517,0.2857142857,0.6666666667,13,14,13,14,1,0,0,0,2,1,1,122,147,122,147,25,0
160,160,1,1,0,1,0,1,0.8151515152,1,1,1,1,1,1,1,0,0,0,0,0,0,0,330,330,330,330,0,0
112,136,25,32,0.0625,0.125,7,28.5,0.329588015,0.5617977528,0.0625,0.3745318352,32,25,25,32,7,0,0,0,2,1,1,267,191,191,267,76,0
181,196,13,16,0.1875,0.1875,3,14.5,0.3904761905,0.6476190476,0.1875,0.419047619,13,16,13,16,3,0,0,0,2,1,1,105,104,104,105,1,0
474,512,39,39,0.3243243243,1,0,39,0.8849104859,1,1,1,37,37,37,37,0,1,1,2,4,2,2,391,391,391,391,0,0
96,223,128,128,0.8494623656,0.9677419355,0,128,0.9597484277,0.9874213836,0.9032258065,0.9597484277,93,93,93,93,0,1,1,2,4,2,2,795,791,791,795,4,0
210,240,30,31,0.3548387097,0.5483870968,1,30.5,0.5602409639,0.7771084337,0.3548387097,0.6024096386,30,31,30,31,1,0,0,0,2,1,1,166,157,157,166,9,0
153,175,23,24,0.0833333333,0.7083333333,1,23.5,0.6086956522,0.8260869565,0.0833333333,0.7080745342,24,23,23,24,1,0,0,0,2,1,1,161,140,140,161,21,0
1440,1458,18,19,0.5263157895,0.8421052632,1,18.5,0.8493975904,0.9457831325,0.4736842105,0.8493975904,18,19,18,19,1,0,0,0,2,1,1,160,166,160,166,6,0
37,59,23,29,0.2068965517,0.275862069,6,26,0.288372093,0.5069767442,0.2068965517,0.3441860465,29,23,23,29,6,0,0,0,2,1,1,215,163,163,215,52,0
1088,1099,12,12,0.5384615385,1,0,12,0.8405797101,1,1,1,13,13,13,13,0,0,0,0,2,1,1,69,69,69,69,0,0
850,862,13,13,0.8461538462,1,0,13,0.9805825243,1,1,1,13,13,13,13,0,2,2,4,2,1,1,103,103,103,103,0,0
377,398,22,22,0,0,0,22,0.3333333333,0.4444444444,0,0.3434343434,22,22,22,22,0,0,0,0,1,0,1,198,110,110,198,88,0
574,584,11,11,1,1,0,11,1,1,1,1,11,11,11,11,0,1,1,2,2,1,1,128,128,128,128,0,0
99,111,13,15,0.1333333333,0.3333333333,2,14,0.3622047244,0.5748031496,0.2,0.4173228346,15,13,13,15,2,0,0,0,3,2,1,127,103,103,127,24,0
701,711,11,11,0.5454545455,1,0,11,0.958677686,1,1,1,11,11,11,11,0,1,1,2,2,1,1,121,121,121,121,0,0
157,243,87,87,0.6086956522,0.9782608696,0,87,0.9251207729,0.9927536232,0.9782608696,0.9927536232,46,46,46,46,0,1,1,2,4,2,2,414,411,411,414,3,0
86,101,16,21,0.1428571429,0.1904761905,5,18.5,0.325,0.5125,0.1428571429,0.3625,21,16,16,21,5,0,0,0,2,1,1,160,114,114,160,46,0
85,94,10,12,0.25,0.3333333333,2,11,0.3793103448,0.5287356322,0.25,0.4367816092,12,10,10,12,2,0,0,0,2,1,1,87,61,61,87,26,0
58,70,10,13,0.2307692308,0.3076923077,3,11.5,0.3561643836,0.5479452055,0.2307692308,0.3835616438,10,13,10,13,3,0,0,0,2,1,1,49,73,49,73,24,0
519,547,29,29,1,1,0,29,1,1,1,1,31,31,31,31,0,0,0,0,2,1,1,306,306,306,306,0,1
346,362,17,17,1,1,0,17,1,1,1,1,17,17,17,17,0,0,0,0,2,1,1,119,119,119,119,0,0
18,29,12,24,0.5,0.5,12,18,0.4953271028,0.4953271028,0.5,0.4953271028,24,12,12,24,12,0,0,0,0,0,0,214,106,106,214,108,0
617,630,14,18,0.1666666667,0.2777777778,4,16,0.4038461538,0.6442307692,0.1666666667,0.4807692308,18,14,14,18,4,0,0,0,2,1,1,96,104,96,104,8,0
574,583,10,10,0.2,0.2,0,10,0.4,0.6166666667,0.2,0.45,10,10,10,10,0,0,0,0,2,1,1,60,55,55,60,5,0
453,493,41,41,1,1,0,41,1,1,1,1,41,41,41,41,0,0,0,0,2,1,1,287,287,287,287,0,0
378,399,22,22,1,1,0,22,1,1,1,1,22,22,22,22,0,0,0,0,2,1,1,154,154,154,154,0,0
365,390,26,26,1,1,0,26,1,1,1,1,26,26,26,26,0,0,0,0,2,1,1,182,182,182,182,0,0
76,76,1,1,0,1,0,1,0.8151515152,1,1,1,1,1,1,1,0,0,0,0,0,0,0,330,330,330,330,0,0
138,147,10,11,0.2307692308,0.7692307692,1,10.5,0.5925925926,0.787037037,0.3846153846,0.6296296296,13,12,12,13,1,0,0,0,2,1,1,102,108,102,108,6,0
629,648,20,20,0.8571428571,1,0,20,0.9806451613,1,1,1,21,21,21,21,0,1,1,2,4,2,2,155,155,155,155,0,1
189,199,11,11,1,1,0,11,1,1,1,1,11,11,11,11,0,0,0,0,2,1,1,138,138,138,138,0,0
84,114,22,31,0.1290322581,0.2258064516,9,26.5,0.2572614108,0.4024896266,0.1290322581,0.2946058091,23,31,23,31,8,0,0,0,2,1,1,138,241,138,241,103,0
874,900,27,27,0.9259259259,1,0,27,0.9896373057,1,1,1,27,27,27,27,0,0,0,0,2,1,1,193,193,193,193,0,1
477,485,9,9,0.6363636364,0.7272727273,0,9,0.6666666667,0.7466666667,0.4545454545,0.56,11,11,11,11,0,0,0,0,2,1,1,75,64,64,75,11,0
447,456,10,10,0.3,0.4,0,10,0.4,0.6615384615,0.4,0.4615384615,10,10,10,10,0,0,0,0,3,2,1,59,65,59,65,6,0
1256,1286,24,31,0.2258064516,0.2580645161,7,27.5,0.3796791444,0.5882352941,0.2258064516,0.449197861,24,31,24,31,7,0,0,0,2,1,1,187,159,159,187,28,0
899,955,57,57,1,1,0,57,1,1,1,1,58,58,58,58,0,2,2,4,2,1,1,368,368,368,368,0,1
1195,1221,27,27,1,1,0,27,1,1,1,1,28,28,28,28,0,2,2,4,2,1,1,224,224,224,224,0,1
483,511,16,29,0.1724137931,0.2413793103,13,22.5,0.25,0.3486842105,0.1724137931,0.2697368421,16,29,16,29,13,0,0,0,2,1,1,69,152,69,152,83,0
164,194,29,31,0.21875,0.40625,2,30,0.4622222222,0.6488888889,0.09375,0.4622222222,29,32,29,32,3,0,0,0,2,1,1,225,218,218,225,7,0
687,696,10,10,0.5,0.6,0,10,0.5333333333,0.7,0.5,0.6333333333,10,10,10,10,0,0,0,0,2,1,1,44,60,44,60,16,0
84,88,5,5,0.6666666667,1,0,5,0.9677419355,1,1,1,6,6,6,6,0,2,2,4,2,1,1,62,62,62,62,0,1
536,547,12,12,1,1,0,12,1,1,1,1,13,13,13,13,0,0,0,0,2,1,1,104,104,104,104,0,1
10,233,1,224,0.0384615385,0.0384615385,223,112.5,0.9333036905,0.9333036905,0.0384615385,0.9333036905,1,26,1,26,25,0,1,1,0,0,0,2099,2249,2099,2249,150,0
263,273,11,21,0.1818181818,0.1818181818,10,16,0.4191176471,0.5808823529,0.1363636364,0.4264705882,22,12,12,22,10,0,0,0,2,1,1,136,118,118,136,18,0
32,48,16,17,0.2352941176,0.2352941176,1,16.5,0.2370689655,0.375,0.2352941176,0.2887931034,16,17,16,17,1,0,0,0,2,1,1,232,118,118,232,114,0
179,192,14,16,0.375,0.625,2,15,0.7226277372,0.8175182482,0.5,0.7226277372,16,15,15,16,1,0,0,0,2,1,1,117,137,117,137,20,0
558,583,26,26,1,1,0,26,1,1,1,1,26,26,26,26,0,0,0,0,2,1,1,182,182,182,182,0,0
223,250,28,45,0.0888888889,0.1777777778,17,36.5,0.3322683706,0.5271565495,0.0888888889,0.3514376997,45,28,28,45,17,0,0,0,2,1,1,313,223,223,313,90,0
279,292,14,15,0.0666666667,0.7333333333,1,14.5,0.3333333333,0.5789473684,0.0666666667,0.3859649123,15,14,14,15,1,0,0,0,2,1,1,102,171,102,171,69,0
370,386,12,17,0.1764705882,0.2352941176,5,14.5,0.3304347826,0.5304347826,0.1764705882,0.4173913043,12,17,12,17,5,0,0,0,2,1,1,83,115,83,115,32,0
10,10,1,29,0.0416666667,0.0416666667,28,15,0.9362176628,0.9362176628,0.0416666667,0.9362176628,24,1,1,24,23,1,0,1,1,1,0,2242,2099,2099,2242,143,0
210,221,12,12,0.0769230769,0.0769230769,0,12,0.3008849558,0.5575221239,0.0769230769,0.3982300885,13,12,12,13,1,0,0,0,2,1,1,99,113,99,113,14,0
465,494,30,30,0,0,0,30,0.4285714286,0.5714285714,0,0.4380952381,30,30,30,30,0,0,0,0,2,1,1,150,210,150,210,60,0
127,136,10,13,0.2307692308,0.3076923077,3,11.5,0.3012048193,0.4939759036,0.2307692308,0.3734939759,13,10,10,13,3,0,0,0,2,1,1,83,46,46,83,37,0
31,54,24,24,1,1,0,24,1,1,1,1,24,24,24,24,0,0,0,0,2,1,1,164,164,164,164,0,1
532,540,9,9,0.7,1,0,9,0.9166666667,1,1,1,10,10,10,10,0,0,0,0,2,1,1,60,60,60,60,0,0
10,27,1,18,0.0666666667,0.0666666667,17,9.5,0.9619615032,0.9619615032,0.0666666667,0.9619615032,1,15,1,15,14,0,0,0,0,0,0,2099,2182,2099,2182,83,0
151,166,10,16,0.125,0.1875,6,13,0.3245614035,0.5175438596,0.125,0.350877193,10,16,10,16,6,0,0,0,2,1,1,79,114,79,114,35,0
22,57,16,36,0.0833333333,0.1111111111,20,26,0.3529411765,0.5490196078,0.0833333333,0.387254902,16,36,16,36,20,0,0,0,2,1,1,147,204,147,204,57,0
168,183,16,16,0.1875,0.3125,0,16,0.358974359,0.5811965812,0.1875,0.3931623932,16,16,16,16,0,0,0,0,2,1,1,117,94,94,117,23,0
125,135,11,17,0.1176470588,0.1176470588,6,14,0.3138686131,0.5620437956,0.1176470588,0.3941605839,17,11,11,17,6,0,0,0,2,1,1,137,106,106,137,31,0
172,186,11,15,0.1875,0.3125,4,13,0.309352518,0.4820143885,0.1875,0.3309352518,12,16,12,16,4,0,0,0,2,1,1,91,139,91,139,48,0
10,10,1,56,0.0357142857,0.0357142857,55,28.5,0.9316466933,0.9316466933,0.0357142857,0.9316466933,28,1,1,28,27,1,0,1,0,0,0,2253,2099,2099,2253,154,0
206,218,11,13,0.3076923077,0.3076923077,2,12,0.5508474576,0.6779661017,0.2307692308,0.4745762712,11,13,11,13,2,0,0,0,2,1,1,100,118,100,118,18,0
382,413,32,32,1,1,0,32,1,1,1,1,32,32,32,32,0,0,0,0,2,1,1,224,224,224,224,0,0
434,465,32,32,1,1,0,32,1,1,1,1,32,32,32,32,0,0,0,0,2,1,1,224,224,224,224,0,0
336,352,17,17,1,1,0,17,1,1,1,1,17,17,17,17,0,0,0,0,2,1,1,119,119,119,119,0,0
497,516,20,24,0.1666666667,0.2916666667,4,22,0.3393939394,0.5454545455,0.1666666667,0.4121212121,24,20,20,24,4,0,0,0,2,1,1,165,118,118,165,47,0
110,119,10,10,0.4,0.7,0,10,0.4516129032,0.5806451613,0.5,0.5161290323,10,10,10,10,0,0,0,0,3,2,1,48,62,48,62,14,0
529,543,12,15,0.4666666667,0.8,3,13.5,0.7096774194,0.7419354839,0.6,0.735483871,12,15,12,15,3,0,0,0,2,1,1,115,155,115,155,40,0
299,309,11,11,0.2727272727,0.4545454545,0,11,0.4054054054,0.6351351351,0.2727272727,0.472972973,11,11,11,11,0,0,0,0,2,1,1,65,74,65,74,9,0
716,733,18,21,0.7272727273,0.7727272727,3,19.5,0.7209302326,0.75,0.3636363636,0.5988372093,22,19,19,22,3,0,0,0,2,1,1,172,132,132,172,40,0
341,351,11,11,0.3636363636,0.4545454545,0,11,0.425,0.5375,0.2727272727,0.4375,11,11,11,11,0,0,0,0,3,2,1,69,80,69,80,11,0
10,27,1,18,0.0666666667,0.0666666667,17,9.5,0.9580100411,0.9580100411,0.0666666667,0.9580100411,1,15,1,15,14,0,1,1,1,0,1,2099,2191,2099,2191,92,0
44,46,3,3,0,1,0,3,0.8214285714,1,0.6666666667,0.9642857143,3,3,3,3,0,0,0,0,2,1,1,56,56,56,56,0,0
72,72,1,1,0,0,0,1,0.0672566372,0.1362831858,0,0.1362831858,1,1,1,1,0,0,0,0,2,1,1,79,565,79,565,486,0
109,115,7,7,0.625,0.875,0,7,0.8421052632,0.8947368421,0.375,0.6578947368,8,8,8,8,0,1,1,2,2,1,1,76,68,68,76,8,0
662,674,10,13,0.2,0.3,3,11.5,0.4745762712,0.7288135593,0.2,0.6101694915,10,10,10,10,0,0,0,0,2,1,1,58,59,58,59,1,0
311,396,86,86,0.9882352941,0.9882352941,0,86,0.9843505477,0.9843505477,0.9882352941,0.9843505477,85,85,85,85,0,1,1,2,4,2,2,629,639,629,639,10,0
23,64,42,42,1,1,0,42,1,1,1,1,39,39,39,39,0,0,0,0,0,0,0,397,397,397,397,0,1
3,39,37,37,1,1,0,37,1,1,1,1,37,37,37,37,0,0,0,0,0,0,0,300,300,300,300,0,1
4,205,202,202,1,1,0,202,1,1,1,1,183,183,183,183,0,0,0,0,0,0,0,1536,1536,1536,1536,0,1
110,116,7,12,0,0.375,5,9.5,0.3623188406,0.5652173913,0.125,0.4637681159,8,7,7,8,1,0,1,1,3,2,1,69,53,53,69,16,0
330,335,6,6,0.4285714286,0.8571428571,0,6,0.6904761905,0.880952381,0.8571428571,0.880952381,7,7,7,7,0,0,0,0,2,1,1,41,42,41,42,1,0
152,158,7,7,0.4285714286,0.7142857143,0,7,0.6052631579,0.8157894737,0.5714285714,0.7631578947,7,7,7,7,0,0,0,0,2,1,1,35,38,35,38,3,0
106,111,6,6,0.5714285714,0.8571428571,0,6,0.9322033898,0.9661016949,0.8571428571,0.9661016949,7,7,7,7,0,1,1,2,2,1,1,59,59,59,59,0,1
522,544,23,23,1,1,0,23,1,1,1,1,25,25,25,25,0,0,0,0,2,1,1,187,187,187,187,0,1
667,685,18,19,0.8571428571,0.9047619048,1,18.5,0.8724832215,0.8926174497,0.7142857143,0.8187919463,20,21,20,21,1,0,0,0,2,1,1,137,149,137,149,12,1
1601,1605,5,5,0.8,1,0,5,0.984375,1,1,1,5,5,5,5,0,0,0,0,2,1,1,64,64,64,64,0,1
538,544,7,7,0,1,0,7,0.9122807018,1,1,1,7,7,7,7,0,0,0,0,2,1,1,114,114,114,114,0,0
319,713,395,395,1,1,0,395,1,1,1,1,354,354,354,354,0,1,1,2,2,1,1,2845,2845,2845,2845,0,1
64,71,8,8,1,1,0,8,1,1,1,1,9,9,9,9,0,0,0,0,2,1,1,62,62,62,62,0,1
1018,1041,24,24,1,1,0,24,1,1,1,1,24,24,24,24,0,4,4,8,2,1,1,132,132,132,132,0,1
561,568,8,8,0.8888888889,1,0,8,0.9807692308,1,1,1,9,9,9,9,0,1,1,2,2,1,1,52,52,52,52,0,1
546,568,21,23,0.84,0.88,2,22,0.8395721925,0.871657754,0.68,0.807486631,23,25,23,25,2,0,0,0,2,1,1,166,187,166,187,21,1
399,543,145,145,0.9857142857,1,0,145,0.9983235541,1,0.9928571429,0.999161777,140,140,140,140,0,1,1,2,2,1,1,1193,1193,1193,1193,0,0
48,716,669,669,1,1,0,669,1,1,1,1,574,574,574,574,0,2,2,4,2,1,1,4904,4904,4904,4904,0,0
163,172,10,12,0.1666666667,0.3333333333,2,11,0.3272727273,0.5454545455,0.1666666667,0.3818181818,12,10,10,12,2,0,0,0,2,1,1,55,48,48,55,7,0
187,195,9,9,0.3,0.7,0,9,0.4691358025,0.6419753086,0.3,0.4938271605,10,10,10,10,0,0,0,0,2,1,1,62,81,62,81,19,0
10,31,1,22,0.0555555556,0.0555555556,21,11.5,0.9527916478,0.9527916478,0.0555555556,0.9527916478,1,18,1,18,17,0,1,1,1,0,1,2099,2203,2099,2203,104,0
19,34,16,16,1,1,0,16,1,1,1,1,16,16,16,16,0,0,0,0,2,1,1,119,119,119,119,0,1
33,51,18,19,0.5789473684,0.7368421053,1,18.5,0.7131147541,0.762295082,0.2631578947,0.5737704918,18,19,18,19,1,0,0,0,2,1,1,104,122,104,122,18,1
624,641,18,23,0.68,0.72,5,20.5,0.7165775401,0.7326203209,0.32,0.5989304813,25,20,20,25,5,0,0,0,2,1,1,187,137,137,187,50,0
546,568,18,23,0.68,0.72,5,20.5,0.7165775401,0.7326203209,0.32,0.5989304813,20,25,20,25,5,0,0,0,2,1,1,137,187,137,187,50,0
18,275,258,258,1,1,0,258,1,1,1,1,225,225,225,225,0,0,0,0,0,0,0,1865,1865,1865,1865,0,0
158,170,13,13,0.3076923077,0.9230769231,0,13,0.7424242424,0.8636363636,0.9230769231,0.8636363636,13,13,13,13,0,0,1,1,2,1,1,59,66,59,66,7,1
277,288,12,12,0.5833333333,1,0,12,0.9553571429,1,1,1,12,12,12,12,0,0,0,0,2,1,1,112,112,112,112,0,1
73,82,10,10,1,1,0,10,1,1,1,1,10,10,10,10,0,0,0,0,2,1,1,62,62,62,62,0,1
130,151,22,22,1,1,0,22,1,1,1,1,24,24,24,24,0,1,1,2,2,1,1,181,181,181,181,0,1
516,520,5,5,0.8571428571,0.8571428571,0,5,0.875,0.8875,0.8571428571,0.8875,7,7,7,7,0,2,2,4,2,1,1,72,80,72,80,8,1
307,323,17,17,1,1,0,17,1,1,1,1,16,16,16,16,0,1,1,2,4,2,2,150,150,150,150,0,1
282,316,35,35,1,1,0,35,1,1,1,1,40,40,40,40,0,2,2,4,0,0,0,308,308,308,308,0,1
149,165,15,17,0.4117647059,0.6470588235,2,16,0.8076923077,0.8901098901,0.1176470588,0.6428571429,15,17,15,17,2,0,0,0,2,1,1,167,182,167,182,15,1
64,76,10,13,0.1666666667,0.1666666667,3,11.5,0.3559322034,0.5254237288,0.1666666667,0.3898305085,10,12,10,12,2,0,1,1,3,1,2,58,59,58,59,1,0
680,706,27,27,1,1,0,27,1,1,1,1,27,27,27,27,0,0,0,0,2,1,1,158,158,158,158,0,1
619,627,9,9,1,1,0,9,1,1,1,1,10,10,10,10,0,0,0,0,2,1,1,78,78,78,78,0,1
335,349,15,15,1,1,0,15,1,1,1,1,15,15,15,15,0,0,0,0,2,1,1,117,117,117,117,0,1
202,265,64,64,1,1,0,64,1,1,1,1,64,64,64,64,0,0,0,0,2,1,1,511,511,511,511,0,1
605,645,41,41,1,1,0,41,1,1,1,1,37,37,37,37,0,0,0,0,4,2,2,214,214,214,214,0,1
6,26,21,23,0.8333333333,0.8333333333,2,22,0.9212598425,0.9527559055,0.0833333333,0.6850393701,12,12,12,12,0,1,1,2,0,0,0,123,127,123,127,4,0
105,116,12,12,1,1,0,12,1,1,1,1,12,12,12,12,0,0,0,0,2,1,1,106,106,106,106,0,1
351,377,27,27,1,1,0,27,1,1,1,1,27,27,27,27,0,1,1,2,2,1,1,351,351,351,351,0,1
58,64,6,7,0.2857142857,0.7142857143,1,6.5,0.6666666667,0.8888888889,0.2857142857,0.7407407407,6,7,6,7,1,0,0,0,2,1,1,25,27,25,27,2,1
678,685,8,8,0.8888888889,1,0,8,0.9807692308,1,1,1,9,9,9,9,0,1,1,2,2,1,1,52,52,52,52,0,1
306,327,22,22,1,1,0,22,1,1,1,1,22,22,22,22,0,0,0,0,2,1,1,154,154,154,154,0,1
247,263,17,17,1,1,0,17,1,1,1,1,19,19,19,19,0,0,0,0,2,1,1,185,185,185,185,0,1
121,153,33,33,1,1,0,33,1,1,1,1,34,34,34,34,0,0,0,0,2,1,1,240,240,240,240,0,1
156,164,9,9,0.6,0.9,0,9,0.8846153846,0.9743589744,0.9,0.9743589744,10,10,10,10,0,1,0,1,2,1,1,76,78,76,78,2,1
758,762,5,5,0.2,1,0,5,0.9541284404,1,1,1,5,5,5,5,0,0,0,0,2,1,1,109,109,109,109,0,1
52,54,3,3,0,1,0,3,0.8846153846,1,1,1,3,3,3,3,0,0,0,0,2,1,1,52,52,52,52,0,1
1,274,274,274,1,1,0,274,1,1,1,1,237,237,237,237,0,0,0,0,0,0,0,1967,1967,1967,1967,0,1
148,154,7,7,0.4285714286,1,0,7,0.8214285714,1,0.8571428571,0.9642857143,7,7,7,7,0,0,0,0,2,1,1,56,56,56,56,0,1
23,26,4,4,0,0,0,4,0.45,0.55,0,0.525,4,4,4,4,0,1,0,1,2,1,1,80,52,52,80,28,0
10,10,1,475,0.0357142857,0.0357142857,474,238,0.9316466933,0.9316466933,0.0357142857,0.9316466933,28,1,1,28,27,1,0,1,0,0,0,2253,2099,2099,2253,154,0
231,247,17,17,1,1,0,17,1,1,1,1,19,19,19,19,0,0,0,0,2,1,1,185,185,185,185,0,1
617,682,63,66,0.6666666667,0.696969697,3,64.5,0.7602459016,0.7889344262,0.1818181818,0.5717213115,63,66,63,66,3,0,0,0,2,1,1,455,488,455,488,33,1
170,180,11,12,0.6153846154,0.6923076923,1,11.5,0.85,0.9083333333,0.1538461538,0.65,13,12,12,13,1,0,0,0,2,1,1,120,117,117,120,3,1
440,452,13,13,1,1,0,13,1,1,1,1,13,13,13,13,0,0,0,0,2,1,1,133,133,133,133,0,1
790,816,27,27,1,1,0,27,1,1,1,1,27,27,27,27,0,0,0,0,2,1,1,193,193,193,193,0,1
48,62,15,15,0.8666666667,0.8666666667,0,15,0.9444444444,0.9722222222,0.4666666667,0.8472222222,15,15,15,15,0,0,0,0,2,1,1,72,72,72,72,0,1
440,452,13,14,0.7142857143,0.7857142857,1,13.5,0.8796992481,0.9172932331,0.5714285714,0.7969924812,14,13,13,14,1,0,0,0,2,1,1,128,133,128,133,5,1
376,387,12,12,1,1,0,12,1,1,1,1,14,14,14,14,0,0,0,0,2,1,1,124,124,124,124,0,1
113,124,12,12,1,1,0,12,1,1,1,1,12,12,12,12,0,0,0,0,2,1,1,67,67,67,67,0,1
32,41,10,10,1,1,0,10,1,1,1,1,12,12,12,12,0,0,0,0,2,1,1,121,121,121,121,0,1
1083,1095,13,17,0.4705882353,0.7647058824,4,15,0.7181208054,0.7583892617,0.2941176471,0.6577181208,17,13,13,17,4,0,0,0,2,1,1,149,113,113,149,36,1
280,289,10,10,1,1,0,10,1,1,1,1,11,11,11,11,0,0,0,0,2,1,1,131,131,131,131,0,1
383,399,17,17,1,1,0,17,1,1,1,1,17,17,17,17,0,0,0,0,2,1,1,119,119,119,119,0,1
408,422,12,15,0.4,0.7333333333,3,13.5,0.6928104575,0.7712418301,0.2666666667,0.6405228758,12,15,12,15,3,0,0,0,2,1,1,118,153,118,153,35,1
546,568,23,23,0.88,1,0,23,0.9786096257,1,1,1,25,25,25,25,0,0,0,0,2,1,1,187,187,187,187,0,1
126,163,38,38,0.9428571429,0.9428571429,0,38,0.903930131,0.9257641921,0.3142857143,0.6855895197,35,35,35,35,0,4,4,8,2,1,1,229,216,216,229,13,1
1,63,63,63,1,1,0,63,1,1,1,1,57,57,57,57,0,0,0,0,0,0,0,545,545,545,545,0,1
225,312,88,88,1,1,0,88,1,1,1,1,94,94,94,94,0,0,0,0,2,1,1,895,895,895,895,0,1
349,363,15,15,1,1,0,15,1,1,1,1,15,15,15,15,0,0,0,0,2,1,1,115,115,115,115,0,1
394,405,12,15,0.5333333333,0.8,3,13.5,0.7304964539,0.7588652482,0.3333333333,0.6453900709,15,12,12,15,3,0,0,0,2,1,1,141,107,107,141,34,0
139,148,10,10,0.3,0.7,0,10,0.4264705882,0.6764705882,0.3,0.5,10,10,10,10,0,0,0,0,2,1,1,51,68,51,68,17,1
325,359,35,35,1,1,0,35,1,1,1,1,35,35,35,35,0,0,0,0,2,1,1,136,136,136,136,0,1
205,211,7,7,1,1,0,7,1,1,1,1,7,7,7,7,0,0,0,0,2,1,1,32,32,32,32,0,1
43,82,40,40,1,1,0,40,1,1,1,1,41,41,41,41,0,1,1,2,2,1,1,408,408,408,408,0,1
54,61,8,8,1,1,0,8,1,1,1,1,8,8,8,8,0,0,0,0,2,1,1,75,75,75,75,0,1
232,245,14,14,1,1,0,14,1,1,1,1,14,14,14,14,0,0,0,0,2,1,1,107,107,107,107,0,1
411,421,11,11,0.5384615385,0.6923076923,0,11,0.7894736842,0.8526315789,0.4615384615,0.6947368421,13,13,13,13,0,0,0,0,2,1,1,95,93,93,95,2,1
549,571,23,23,1,1,0,23,1,1,1,1,23,23,23,23,0,0,0,0,2,1,1,210,210,210,210,0,1
331,344,14,14,1,1,0,14,1,1,1,1,16,16,16,16,0,0,0,0,2,1,1,122,122,122,122,0,1
570,590,21,21,1,1,0,21,1,1,1,1,23,23,23,23,0,0,0,0,2,1,1,166,166,166,166,0,1
73,82,10,10,1,1,0,10,1,1,1,1,10,10,10,10,0,0,0,0,2,1,1,62,62,62,62,0,1
440,452,13,13,1,1,0,13,1,1,1,1,13,13,13,13,0,0,0,0,2,1,1,133,133,133,133,0,1
432,445,14,14,1,1,0,14,1,1,1,1,15,15,15,15,0,2,2,4,2,1,1,126,126,126,126,0,1
149,157,9,9,1,1,0,9,1,1,1,1,11,11,11,11,0,0,0,0,2,1,1,105,105,105,105,0,1
99,111,13,13,1,1,0,13,1,1,1,1,13,13,13,13,0,0,0,0,2,1,1,117,117,117,117,0,1
184,198,15,17,0.8235294118,0.8823529412,2,16,0.8909090909,0.9,0.6470588235,0.8590909091,17,15,15,17,2,0,0,0,2,1,1,220,198,198,220,22,1
387,403,17,17,1,1,0,17,1,1,1,1,17,17,17,17,0,0,0,0,2,1,1,119,119,119,119,0,1
277,288,12,12,1,1,0,12,1,1,1,1,12,12,12,12,0,0,0,0,2,1,1,112,112,112,112,0,1
260,270,10,11,0.7272727273,0.8181818182,1,10.5,0.6842105263,0.7473684211,0.7272727273,0.6947368421,10,11,10,11,1,0,0,0,2,1,1,77,95,77,95,18,1
32,38,7,7,0.875,1,0,7,0.9863013699,1,1,1,8,8,8,8,0,0,0,0,2,1,1,73,73,73,73,0,1
629,646,18,23,0.68,0.72,5,20.5,0.7165775401,0.7326203209,0.32,0.5989304813,25,20,20,25,5,0,0,0,2,1,1,187,137,137,187,50,1
399,408,10,11,0.1818181818,0.8181818182,1,10.5,0.7969924812,0.8646616541,0.3636363636,0.7218045113,11,10,10,11,1,0,0,0,2,1,1,133,124,124,133,9,1
546,568,21,23,0.84,0.88,2,22,0.8395721925,0.871657754,0.68,0.807486631,23,25,23,25,2,0,0,0,2,1,1,166,187,166,187,21,1
493,507,15,15,1,1,0,15,1,1,1,1,16,16,16,16,0,0,0,0,2,1,1,173,173,173,173,0,1
809,815,7,7,0.7142857143,0.7142857143,0,7,0.6428571429,0.6714285714,0.1428571429,0.5142857143,7,7,7,7,0,1,1,2,2,1,1,50,70,50,70,20,1
248,261,12,14,0.5714285714,0.8571428571,2,13,0.8201438849,0.8489208633,0.2857142857,0.7122302158,12,14,12,14,2,0,0,0,2,1,1,118,139,118,139,21,1
175,186,12,12,1,1,0,12,1,1,1,1,12,12,12,12,0,0,0,0,2,1,1,72,72,72,72,0,1
60,74,15,15,0.6666666667,1,0,15,0.9411764706,1,1,1,15,15,15,15,0,0,0,0,2,1,1,170,170,170,170,0,1
138,167,28,30,0.9333333333,0.9333333333,2,29,0.9730941704,0.9730941704,0.8666666667,0.9596412556,28,30,28,30,2,0,0,0,2,1,1,217,223,217,223,6,1
513,531,19,19,1,1,0,19,1,1,1,1,20,20,20,20,0,0,0,0,2,1,1,235,235,235,235,0,1
526,530,5,6,0,0,1,5.5,0.2962962963,0.5061728395,0,0.3827160494,6,5,5,6,1,0,0,0,2,1,1,81,56,56,81,25,0
222,253,32,32,1,1,0,32,1,1,1,1,33,33,33,33,0,0,0,0,2,1,1,235,235,235,235,0,1
51,67,17,17,0.4705882353,0.5882352941,0,17,0.5333333333,0.7,0.4705882353,0.6222222222,17,17,17,17,0,0,0,0,2,1,1,90,78,78,90,12,1
648,665,18,21,0.7391304348,0.7826086957,3,19.5,0.7951807229,0.813253012,0.347826087,0.656626506,23,20,20,23,3,0,0,0,2,1,1,166,137,137,166,29,1
762,773,11,12,0.5833333333,0.8333333333,1,11.5,0.8240740741,0.9351851852,0.3333333333,0.75,11,12,11,12,1,0,0,0,2,1,1,105,108,105,108,3,1
322,360,39,39,0.9487179487,0.9487179487,0,39,0.9730639731,0.9730639731,0.8205128205,0.9562289562,39,39,39,39,0,0,0,0,2,1,1,297,296,296,297,1,1
202,210,9,9,0,0.5555555556,0,9,0.7301587302,0.9365079365,0,0.8571428571,9,9,9,9,0,0,0,0,2,1,1,63,63,63,63,0,0
161,170,10,10,0.9,1,0,10,0.987012987,1,1,1,10,10,10,10,0,0,0,0,2,1,1,77,77,77,77,0,1
437,453,17,17,1,1,0,17,1,1,1,1,17,17,17,17,0,1,1,2,2,1,1,344,344,344,344,0,1
616,637,20,22,0.3636363636,0.7727272727,2,21,0.8,0.8666666667,0.6818181818,0.8431372549,20,22,20,22,2,0,0,0,2,1,1,221,255,221,255,34,1
911,929,19,19,1,1,0,19,1,1,1,1,20,20,20,20,0,0,0,0,2,1,1,93,93,93,93,0,1
570,590,18,21,0.7391304348,0.7826086957,3,19.5,0.7951807229,0.813253012,0.347826087,0.656626506,20,23,20,23,3,0,0,0,2,1,1,137,166,137,166,29,0
693,702,10,10,1,1,0,10,1,1,1,1,10,10,10,10,0,0,0,0,2,1,1,113,113,113,113,0,1
319,327,9,9,1,1,0,9,1,1,1,1,9,9,9,9,0,0,0,0,2,1,1,112,112,112,112,0,0
468,488,21,21,0.9523809524,0.9523809524,0,21,0.9938271605,0.9938271605,0.9523809524,0.9938271605,21,21,21,21,0,1,1,2,2,1,1,162,162,162,162,0,0
50,55,6,7,0.2857142857,0.8571428571,1,6.5,0.5777777778,0.9111111111,0.1428571429,0.7555555556,7,6,6,7,1,0,0,0,2,1,1,45,41,41,45,4,0
650,667,18,21,0.7391304348,0.7826086957,3,19.5,0.7951807229,0.813253012,0.347826087,0.656626506,23,20,20,23,3,0,0,0,2,1,1,166,137,137,166,29,0
307,337,31,31,1,1,0,31,1,1,1,1,31,31,31,31,0,0,0,0,2,1,1,217,217,217,217,0,0
612,618,7,7,0.5714285714,0.8571428571,0,7,0.6216216216,0.8108108108,0.7142857143,0.7297297297,7,7,7,7,0,0,0,0,2,1,1,37,32,32,37,5,0
308,318,11,11,0.9090909091,1,0,11,0.9852941176,1,1,1,11,11,11,11,0,1,1,2,2,1,1,68,68,68,68,0,1
44,78,35,35,0.8709677419,0.935483871,0,35,0.9547038328,0.9651567944,0.935483871,0.9651567944,31,31,31,31,0,1,1,2,4,2,2,287,287,287,287,0,0
465,488,24,24,0,0,0,24,0.4285714286,0.5714285714,0,0.4404761905,24,24,24,24,0,0,0,0,2,1,1,120,168,120,168,48,0
184,211,11,28,0.0357142857,0.0357142857,17,19.5,0.0986666667,0.1866666667,0.0357142857,0.1226666667,11,28,11,28,17,0,0,0,2,1,1,95,375,95,375,280,0
124,138,10,15,0.0666666667,0.2666666667,5,12.5,0.3711340206,0.6597938144,0.0666666667,0.4536082474,10,15,10,15,5,0,0,0,2,1,1,86,97,86,97,11,0
89,115,27,27,0.2592592593,0.4444444444,0,27,0.4819277108,0.6506024096,0.1851851852,0.4939759036,27,27,27,27,0,0,0,0,2,1,1,150,166,150,166,16,0
160,160,1,1,1,1,0,1,1,1,1,1,1,1,1,1,0,0,0,0,0,0,0,330,330,330,330,0,0
87,102,16,18,0.7222222222,0.7222222222,2,17,0.7058823529,0.7745098039,0.3333333333,0.6078431373,18,16,16,18,2,0,0,0,2,1,1,102,84,84,102,18,0
125,134,10,10,0.4,0.7,0,10,0.5694444444,0.7916666667,0.3,0.5972222222,10,10,10,10,0,0,0,0,2,1,1,65,72,65,72,7,0
394,404,11,11,1,1,0,11,1,1,1,1,12,12,12,12,0,0,0,0,2,1,1,159,159,159,159,0,1
1337,1372,36,36,1,1,0,36,1,1,1,1,38,38,38,38,0,0,0,0,2,1,1,289,289,289,289,0,1
473,480,8,12,0.1666666667,0.5,4,10,0.3924050633,0.5696202532,0.3333333333,0.5189873418,12,8,8,12,4,1,0,1,2,1,1,79,57,57,79,22,0
469,471,3,3,0,1,0,3,0.9365079365,1,1,1,3,3,3,3,0,0,0,0,2,1,1,126,126,126,126,0,1
145,179,32,35,0.6571428571,0.8285714286,3,33.5,0.7832817337,0.8204334365,0.4,0.6996904025,32,35,32,35,3,0,0,0,2,1,1,267,323,267,323,56,0
20,46,25,27,0.8965517241,0.8965517241,2,26,0.9516129032,0.9677419355,0.5172413793,0.8306451613,27,29,27,29,2,3,4,7,2,1,1,241,248,241,248,7,0
100,112,13,15,0.1666666667,0.1666666667,2,14,0.3452380952,0.5238095238,0.1666666667,0.3928571429,11,12,11,12,1,0,1,1,4,2,2,73,84,73,84,11,0
265,280,16,16,0.875,0.875,0,16,0.9069767442,0.9069767442,0.0625,0.6337209302,16,16,16,16,0,0,1,1,2,1,1,172,163,163,172,9,0
1104,1117,13,14,0.1428571429,0.1428571429,1,13.5,0.37,0.64,0.1428571429,0.49,13,14,13,14,1,0,0,0,2,1,1,90,100,90,100,10,0
412,433,22,22,0,0,0,22,0.4444444444,0.6666666667,0,0.6666666667,22,22,22,22,0,0,0,0,1,0,1,198,154,154,198,44,0
1154,1160,7,9,0.5555555556,0.6666666667,2,8,0.9333333333,0.9555555556,0.6666666667,0.9555555556,9,7,7,9,2,0,0,0,2,1,1,45,43,43,45,2,1
753,779,27,27,1,1,0,27,1,1,1,1,27,27,27,27,0,0,0,0,2,1,1,193,193,193,193,0,1
11,36,26,26,0.9583333333,1,0,26,0.9935483871,1,1,1,24,24,24,24,0,3,3,6,2,1,1,155,155,155,155,0,1
406,434,29,29,1,1,0,29,1,1,1,1,29,29,29,29,0,0,0,0,2,1,1,347,347,347,347,0,1
185,210,26,26,1,1,0,26,1,1,1,1,26,26,26,26,0,0,0,0,2,1,1,337,337,337,337,0,1
165,176,11,12,0.25,0.5,1,11.5,0.4204545455,0.6477272727,0.25,0.4772727273,11,12,11,12,1,0,0,0,2,1,1,88,72,72,88,16,0
19,34,16,16,1,1,0,16,1,1,1,1,16,16,16,16,0,0,0,0,2,1,1,119,119,119,119,0,1
395,408,14,14,0.3571428571,1,0,14,0.9307692308,1,0.9285714286,0.9923076923,14,14,14,14,0,0,0,0,2,1,1,130,130,130,130,0,1
602,611,10,11,0.1818181818,0.2727272727,1,10.5,0.3684210526,0.5657894737,0.1818181818,0.3947368421,11,10,10,11,1,0,0,0,2,1,1,76,61,61,76,15,0
1083,1095,13,13,0.6923076923,0.9230769231,0,13,0.9391304348,0.9739130435,0.4615384615,0.8608695652,13,13,13,13,0,0,0,0,2,1,1,115,113,113,115,2,1
159,173,15,15,1,1,0,15,1,1,1,1,15,15,15,15,0,0,0,0,2,1,1,190,190,190,190,0,1
1382,1399,18,18,1,1,0,18,1,1,1,1,21,21,21,21,0,0,0,0,2,1,1,141,141,141,141,0,1
159,173,15,15,1,1,0,15,1,1,1,1,15,15,15,15,0,0,0,0,2,1,1,190,190,190,190,0,1
105,116,12,12,1,1,0,12,1,1,1,1,12,12,12,12,0,0,0,0,2,1,1,106,106,106,106,0,1
575,597,23,23,1,1,0,23,1,1,1,1,23,23,23,23,0,3,3,6,2,1,1,186,186,186,186,0,1
100,111,12,12,1,1,0,12,1,1,1,1,13,13,13,13,0,0,0,0,2,1,1,95,95,95,95,0,1
770,795,26,28,0.4827586207,0.6206896552,2,27,0.752851711,0.8365019011,0.2413793103,0.63878327,29,28,28,29,1,0,0,0,2,1,1,263,257,257,263,6,1
838,856,19,19,1,1,0,19,1,1,1,1,19,19,19,19,0,3,3,6,2,1,1,171,171,171,171,0,1
664,673,10,10,1,1,0,10,1,1,1,1,10,10,10,10,0,0,0,0,2,1,1,89,89,89,89,0,1
793,801,9,9,1,1,0,9,1,1,1,1,11,11,11,11,0,0,0,0,2,1,1,75,75,75,75,0,1
940,952,13,13,0.6153846154,1,0,13,0.958677686,1,1,1,13,13,13,13,0,0,0,0,2,1,1,121,121,121,121,0,1
417,720,304,304,1,1,0,304,1,1,1,1,288,288,288,288,0,2,2,4,2,1,1,2224,2224,2224,2224,0,0
658,677,20,20,0.9523809524,0.9523809524,0,20,0.9912280702,0.9912280702,0.9523809524,0.9912280702,21,21,21,21,0,0,0,0,2,1,1,114,114,114,114,0,1
553,561,9,9,1,1,0,9,1,1,1,1,9,9,9,9,0,3,3,6,2,1,1,130,130,130,130,0,1
546,568,21,23,0.84,0.88,2,22,0.8395721925,0.871657754,0.68,0.807486631,23,25,23,25,2,0,0,0,2,1,1,166,187,166,187,21,1
355,377,23,23,1,1,0,23,1,1,1,1,25,25,25,25,0,1,1,2,4,2,2,212,212,212,212,0,1
187,195,9,9,0.6363636364,0.7272727273,0,9,0.8461538462,0.8974358974,0.7272727273,0.8974358974,11,11,11,11,0,0,0,0,2,1,1,74,78,74,78,4,0
81,86,6,11,0.1818181818,0.3636363636,5,8.5,0.6990291262,0.8155339806,0.1818181818,0.6796116505,11,6,6,11,5,0,0,0,2,1,1,103,84,84,103,19,0
133,146,11,14,0.2142857143,0.2142857143,3,12.5,0.2476190476,0.419047619,0.2142857143,0.2952380952,11,14,11,14,3,0,0,0,2,1,1,61,105,61,105,44,0
683,708,26,26,0.5384615385,0.8461538462,0,26,0.8790322581,0.9677419355,0.8461538462,0.9677419355,26,26,26,26,0,0,0,0,2,1,1,124,124,124,124,0,0
65,71,7,7,0.375,0.75,0,7,0.7213114754,0.8524590164,0.25,0.606557377,8,8,8,8,0,0,0,0,2,1,1,61,56,56,61,5,0
251,308,58,58,0.3272727273,1,0,58,0.8784722222,1,1,1,55,55,55,55,0,1,1,2,4,2,2,576,576,576,576,0,0
174,213,37,40,0.4347826087,0.9130434783,3,38.5,0.8636363636,0.9909090909,0.8695652174,0.9772727273,23,23,23,23,0,1,1,2,4,2,2,220,220,220,220,0,0
72,83,12,12,1,1,0,12,1,1,1,1,12,12,12,12,0,0,0,0,2,1,1,100,100,100,100,0,0
116,130,12,15,0.4,0.8,3,13.5,0.7106918239,0.748427673,0.5333333333,0.7358490566,12,15,12,15,3,0,0,0,2,1,1,119,159,119,159,40,1
157,169,13,13,0.3076923077,0.9230769231,0,13,0.7843137255,0.9411764706,0.9230769231,0.9411764706,13,13,13,13,0,0,1,1,2,1,1,51,49,49,51,2,1
1014,1020,7,7,0.8333333333,1,0,7,0.9814814815,1,1,1,6,6,6,6,0,1,1,2,2,1,1,54,54,54,54,0,1
535,543,9,9,0.9,0.9,0,9,0.8595041322,0.8925619835,0.1,0.6446280992,10,10,10,10,0,2,2,4,2,1,1,108,121,108,121,13,1
53,72,20,20,0.8,1,0,20,0.9756097561,1,1,1,20,20,20,20,0,1,1,2,2,1,1,164,164,164,164,0,1
355,361,7,7,1,1,0,7,1,1,1,1,7,7,7,7,0,0,0,0,2,1,1,34,34,34,34,0,1
10,10,1,1,1,1,0,1,1,1,1,1,1,1,1,1,0,0,0,0,0,0,0,2099,2099,2099,2099,0,0
439,470,32,32,1,1,0,32,1,1,1,1,32,32,32,32,0,0,0,0,2,1,1,224,224,224,224,0,0
219,223,5,5,0.4,0.4,0,5,0.90625,0.90625,0.4,0.90625,5,5,5,5,0,0,0,0,2,1,1,64,60,60,64,4,1
64,73,10,10,0.4,0.7,0,10,0.6515151515,0.8181818182,0.3,0.5909090909,10,10,10,10,0,0,0,0,2,1,1,61,66,61,66,5,0
82,92,11,11,1,1,0,11,1,1,1,1,13,13,13,13,0,1,1,2,2,1,1,132,132,132,132,0,1
44,57,14,16,0.7647058824,0.7647058824,2,15,0.547008547,0.6196581197,0.6470588235,0.5299145299,17,15,15,17,2,0,0,0,2,1,1,188,234,188,234,46,1
120,133,14,14,0.9333333333,0.9333333333,0,14,0.7701149425,0.7816091954,0.4,0.5977011494,15,15,15,15,0,2,2,4,2,1,1,87,68,68,87,19,1
76,85,10,10,1,1,0,10,1,1,1,1,10,10,10,10,0,0,0,0,2,1,1,104,104,104,104,0,1
703,751,49,49,0.3673469388,0.612244898,0,49,0.7728813559,0.813559322,0.2448979592,0.593220339,43,49,43,49,6,0,1,1,2,1,1,243,295,243,295,52,1
181,194,14,21,0.1428571429,0.1904761905,7,17.5,0.3214285714,0.4785714286,0.1428571429,0.3571428571,21,14,14,21,7,0,0,0,2,1,1,140,92,92,140,48,0
43,74,31,32,0.9090909091,0.9090909091,1,31.5,0.9871244635,0.9871244635,0.9090909091,0.9871244635,32,33,32,33,1,1,1,2,2,1,1,233,232,232,233,1,1
433,462,30,30,1,1,0,30,1,1,1,1,30,30,30,30,0,0,0,0,2,1,1,210,210,210,210,0,0
307,331,25,25,0.88,0.96,0,25,0.8815789474,0.9868421053,0.96,0.9868421053,25,25,25,25,0,1,1,2,2,1,1,226,228,226,228,2,1
115,130,16,18,0.4444444444,0.7777777778,2,17,0.8043478261,0.8695652174,0.5,0.8097826087,18,16,16,18,2,0,0,0,2,1,1,184,161,161,184,23,1
433,582,150,150,0.9864864865,0.9864864865,0,150,0.9858601728,0.9858601728,0.2702702703,0.7022780833,148,147,147,148,1,4,4,8,2,1,1,1273,1255,1255,1273,18,1
394,404,11,11,1,1,0,11,1,1,1,1,12,12,12,12,0,0,0,0,2,1,1,159,159,159,159,0,1
568,582,13,15,0.4,0.8,2,14,0.6304347826,0.75,0.6666666667,0.652173913,13,15,13,15,2,0,0,0,2,1,1,69,92,69,92,23,1
860,869,10,11,0.7692307692,0.7692307692,1,10.5,0.8282828283,0.8484848485,0.2307692308,0.6464646465,13,12,12,13,1,0,0,0,2,1,1,99,87,87,99,12,1
818,870,53,53,0.8285714286,0.9714285714,0,53,0.9380530973,0.9778761062,0.4857142857,0.7522123894,35,35,35,35,0,1,1,2,3,1,2,225,226,225,226,1,0
90,127,38,38,1,1,0,38,1,1,1,1,40,40,40,40,0,1,1,2,4,2,2,310,310,310,310,0,0
74,85,10,12,0.1666666667,0.1666666667,2,11,0.4210526316,0.6447368421,0.1666666667,0.4736842105,10,12,10,12,2,0,0,0,2,1,1,67,76,67,76,9,0
90,165,76,76,1,1,0,76,1,1,1,1,19,19,19,19,0,0,0,0,0,0,0,2083,2083,2083,2083,0,0
27,55,29,41,0.0476190476,0.119047619,12,35,0.3051282051,0.5102564103,0.0476190476,0.3564102564,42,29,29,42,13,0,0,0,2,1,1,390,260,260,390,130,0
500,534,35,35,0.3636363636,1,0,35,0.9090909091,1,1,1,33,33,33,33,0,1,1,2,4,2,2,363,363,363,363,0,1
463,492,30,30,0,0,0,30,0.4285714286,0.5714285714,0,0.4380952381,30,30,30,30,0,0,0,0,2,1,1,150,210,150,210,60,0
313,343,31,31,1,1,0,31,1,1,1,1,31,31,31,31,0,0,0,0,2,1,1,217,217,217,217,0,0
593,599,7,7,0.4285714286,0.7142857143,0,7,0.5428571429,0.7142857143,0.4285714286,0.6,7,7,7,7,0,0,0,0,3,1,2,35,35,35,35,0,0
476,499,14,24,0.125,0.2916666667,10,19,0.35,0.54375,0.125,0.39375,14,24,14,24,10,0,0,0,2,1,1,99,160,99,160,61,0
252,262,11,11,0.2727272727,0.2727272727,0,11,0.3815789474,0.6052631579,0.2727272727,0.4736842105,11,11,11,11,0,0,0,0,2,1,1,72,76,72,76,4,0
380,395,16,19,0.2105263158,0.2631578947,3,17.5,0.3909774436,0.6616541353,0.2105263158,0.4586466165,19,16,16,19,3,0,0,0,2,1,1,133,124,124,133,9,0
52,55,4,6,0.1666666667,0.5,2,5,0.632183908,0.6551724138,0.5,0.6551724138,6,4,4,6,2,1,0,1,2,1,1,87,58,58,87,29,1
99,113,15,15,0.4666666667,0.7333333333,0,15,0.7844311377,0.8982035928,0.1333333333,0.6347305389,15,15,15,15,0,0,0,0,2,1,1,155,167,155,167,12,1
219,228,10,10,0.2727272727,0.2727272727,0,10,0.4426229508,0.606557377,0.2727272727,0.4918032787,11,10,10,11,1,0,0,0,2,1,1,61,61,61,61,0,0
24,125,102,117,0.8333333333,0.8583333333,15,109.5,0.8941947566,0.8979400749,0.1583333333,0.6994382022,120,105,105,120,15,0,0,0,2,1,1,1068,960,960,1068,108,1
475,500,26,26,1,1,0,26,1,1,1,1,26,26,26,26,0,0,0,0,2,1,1,182,182,182,182,0,0
283,314,28,32,0.7647058824,0.7647058824,4,30,0.7427745665,0.7543352601,0.0882352941,0.5028901734,30,34,30,34,4,0,0,0,2,1,1,320,346,320,346,26,0
551,552,2,2,0.5,0.75,0,2,0.8461538462,0.9487179487,0.75,0.9230769231,4,4,4,4,0,2,2,4,2,1,1,37,39,37,39,2,0
58,69,12,14,0.6428571429,0.7142857143,2,13,0.7516778523,0.7986577181,0.4285714286,0.7248322148,14,12,12,14,2,0,0,0,2,1,1,149,119,119,149,30,0
298,307,10,10,1,1,0,10,1,1,1,1,10,10,10,10,0,0,0,0,2,1,1,45,45,45,45,0,1
21,33,13,13,1,1,0,13,1,1,1,1,14,14,14,14,0,1,1,2,2,1,1,90,90,90,90,0,1
24,30,7,7,0.875,1,0,7,0.9841269841,1,1,1,8,8,8,8,0,0,0,0,2,1,1,63,63,63,63,0,1
370,399,30,30,1,1,0,30,1,1,1,1,30,30,30,30,0,0,0,0,2,1,1,210,210,210,210,0,0
215,218,4,4,0,1,0,4,0.8085106383,1,1,1,5,5,5,5,0,1,1,2,2,1,1,47,47,47,47,0,1
113,124,12,12,1,1,0,12,1,1,1,1,12,12,12,12,0,0,0,0,2,1,1,67,67,67,67,0,1
10,47,1,38,0.0384615385,0.0384615385,37,19.5,0.9333036905,0.9333036905,0.0384615385,0.9333036905,1,26,1,26,25,0,1,1,0,0,0,2099,2249,2099,2249,150,0
72,80,9,9,0.8888888889,1,0,9,0.9896907216,1,1,1,9,9,9,9,0,0,0,0,2,1,1,97,97,97,97,0,1
242,255,14,14,0.625,0.625,0,14,0.8770491803,0.9098360656,0.375,0.7213114754,16,16,16,16,0,0,0,0,2,1,1,122,122,122,122,0,1
964,981,18,18,1,1,0,18,1,1,1,1,19,19,19,19,0,0,0,0,2,1,1,173,173,173,173,0,1
616,625,8,10,0.6,0.7,2,9,0.6708860759,0.6835443038,0.5,0.6329113924,8,10,8,10,2,1,0,1,2,1,1,59,79,59,79,20,1
910,922,11,13,0.5384615385,0.8461538462,2,12,0.7933884298,0.867768595,0.3076923077,0.7107438017,11,13,11,13,2,0,0,0,2,1,1,105,121,105,121,16,1
619,627,9,9,1,1,0,9,1,1,1,1,10,10,10,10,0,0,0,0,2,1,1,78,78,78,78,0,1
20,31,12,18,0.2222222222,0.2222222222,6,15,0.3302752294,0.5137614679,0.2222222222,0.4036697248,18,12,12,18,6,0,0,0,2,1,1,109,79,79,109,30,0
216,229,14,14,1,1,0,14,1,1,1,1,14,14,14,14,0,0,0,0,2,1,1,107,107,107,107,0,1
1078,1089,12,12,1,1,0,12,1,1,1,1,10,10,10,10,0,1,1,2,4,2,2,111,111,111,111,0,1
43,47,5,5,0,0.8,0,5,0.8852459016,0.9672131148,0.8,0.9672131148,5,5,5,5,0,0,1,1,2,1,1,61,59,59,61,2,0
102,112,8,11,0.2727272727,0.6363636364,3,9.5,0.4909090909,0.6909090909,0.3636363636,0.5454545455,8,11,8,11,3,0,0,0,3,1,2,52,55,52,55,3,0
28,34,7,7,0.1428571429,0.7142857143,0,7,0.5283018868,0.8679245283,0.1428571429,0.6981132075,7,7,7,7,0,0,0,0,2,1,1,53,49,49,53,4,0
256,272,17,17,0.5263157895,0.9473684211,0,17,0.8736263736,0.956043956,0.9473684211,0.9505494505,19,19,19,19,0,0,1,1,2,1,1,176,182,176,182,6,1
531,544,14,14,0.8666666667,0.9333333333,0,14,0.9285714286,0.9523809524,0.5333333333,0.7976190476,15,15,15,15,0,2,3,5,2,1,1,80,84,80,84,4,0
114,121,8,8,0.5,0.875,0,8,0.696969697,0.9090909091,0.875,0.9090909091,8,8,8,8,0,0,0,0,2,1,1,33,33,33,33,0,0
565,575,9,11,0.6153846154,0.7692307692,2,10,0.696969697,0.7474747475,0.3846153846,0.5757575758,11,13,11,13,2,0,0,0,2,1,1,75,99,75,99,24,0
822,843,22,23,0.7391304348,0.8695652174,1,22.5,0.85,0.8818181818,0.3043478261,0.6136363636,23,22,22,23,1,4,4,8,2,1,1,220,194,194,220,26,1
133,148,10,16,0.0909090909,0.0909090909,6,13,0.4,0.6142857143,0.0909090909,0.5,9,11,9,11,2,1,0,1,4,2,2,64,70,64,70,6,0
205,208,4,4,0.75,1,0,4,0.8289473684,1,0.75,0.9868421053,4,4,4,4,0,0,0,0,2,1,1,76,76,76,76,0,0
425,436,12,13,0.5384615385,0.9230769231,1,12.5,0.8429752066,0.9256198347,0.3846153846,0.7685950413,13,12,12,13,1,0,0,0,2,1,1,121,112,112,121,9,0
455,482,28,28,0.8928571429,0.8928571429,0,28,0.9803921569,0.9803921569,0.8928571429,0.9803921569,28,28,28,28,0,0,0,0,2,1,1,153,150,150,153,3,1
507,513,7,7,0.2857142857,0.8571428571,0,7,0.6935483871,0.8064516129,0.8571428571,0.8064516129,7,7,7,7,0,0,1,1,2,1,1,52,62,52,62,10,0
551,557,7,7,0.7142857143,1,0,7,0.9718309859,1,1,1,7,7,7,7,0,1,1,2,2,1,1,71,71,71,71,0,0
648,665,18,23,0.68,0.72,5,20.5,0.7165775401,0.7326203209,0.32,0.5989304813,25,20,20,25,5,0,0,0,2,1,1,187,137,137,187,50,0
831,840,10,10,0.7,1,0,10,0.90625,1,1,1,10,10,10,10,0,0,0,0,2,1,1,64,64,64,64,0,1
1201,1214,14,14,0.7857142857,1,0,14,0.9666666667,1,1,1,14,14,14,14,0,0,0,0,2,1,1,120,120,120,120,0,1
477,507,31,31,1,1,0,31,1,1,1,1,31,31,31,31,0,0,0,0,2,1,1,217,217,217,217,0,1
55,57,3,3,0,1,0,3,0.8653846154,1,1,1,3,3,3,3,0,0,0,0,2,1,1,52,52,52,52,0,0
194,203,10,10,1,1,0,10,1,1,1,1,8,8,8,8,0,0,0,0,2,1,1,59,59,59,59,0,1
13,18,6,6,0.5,0.8333333333,0,6,0.8392857143,0.9285714286,0,0.5714285714,6,6,6,6,0,0,0,0,0,0,0,56,52,52,56,4,0
665,673,9,9,0.4545454545,0.8181818182,0,9,0.7590361446,0.8915662651,0.4545454545,0.6987951807,11,11,11,11,0,0,0,0,2,1,1,83,75,75,83,8,0
676,676,1,11,0,0,10,6,0.3575418994,0.4525139665,0,0.4525139665,11,12,11,12,1,0,1,1,2,1,1,92,179,92,179,87,0
62,78,17,17,0.7368421053,1,0,17,0.9696969697,1,1,1,19,19,19,19,0,1,1,2,2,1,1,165,165,165,165,0,1
343,356,14,15,0.25,0.5833333333,1,14.5,0.5909090909,0.8636363636,0.25,0.7121212121,12,11,11,12,1,1,1,2,4,2,2,66,63,63,66,3,0
65,70,6,7,0.1428571429,0.7142857143,1,6.5,0.5106382979,0.8510638298,0.4285714286,0.7234042553,7,6,6,7,1,0,0,0,2,1,1,47,41,41,47,6,0
30,35,6,7,0.1428571429,0.7142857143,1,6.5,0.4418604651,0.7674418605,0.2857142857,0.6976744186,7,6,6,7,1,0,0,0,2,1,1,43,36,36,43,7,0
425,436,12,12,0.6666666667,0.9166666667,0,12,0.8571428571,0.9553571429,0.4166666667,0.7767857143,12,12,12,12,0,0,0,0,2,1,1,108,112,108,112,4,1
454,470,13,17,0.4117647059,0.7058823529,4,15,0.6136363636,0.6875,0.2941176471,0.5795454545,13,17,13,17,4,0,0,0,2,1,1,121,176,121,176,55,1
382,387,6,6,0.1666666667,0.8333333333,0,6,0.7179487179,0.9358974359,0.8333333333,0.9230769231,6,6,6,6,0,0,0,0,2,1,1,78,78,78,78,0,0
43,52,10,10,1,1,0,10,1,1,1,1,10,10,10,10,0,0,0,0,2,1,1,88,88,88,88,0,1
88,92,5,5,0.6666666667,1,0,5,0.9677419355,1,1,1,6,6,6,6,0,2,2,4,2,1,1,62,62,62,62,0,1
150,154,5,9,0.1111111111,0.1111111111,4,7,0.3648648649,0.5945945946,0.1111111111,0.472972973,9,5,5,9,4,1,0,1,2,1,1,74,59,59,74,15,0
328,346,19,21,0.375,0.875,2,20,0.8142857143,0.9571428571,0.875,0.9285714286,8,8,8,8,0,1,1,2,4,2,2,70,69,69,70,1,1
904,914,11,11,0.3846153846,0.6923076923,0,11,0.8487394958,0.9159663866,0.0769230769,0.6722689076,12,13,12,13,1,1,0,1,2,1,1,113,119,113,119,6,1
1237,1271,35,35,1,1,0,35,1,1,1,1,36,36,36,36,0,0,0,0,2,1,1,261,261,261,261,0,1
496,510,15,18,0.3333333333,0.8333333333,3,16.5,0.7945945946,0.8864864865,0.6111111111,0.8540540541,18,15,15,18,3,0,0,0,2,1,1,185,164,164,185,21,1
648,665,18,18,1,1,0,18,1,1,1,1,20,20,20,20,0,0,0,0,2,1,1,137,137,137,137,0,1
51,700,154,650,0.2404287902,0.2404287902,496,402,0.2521929825,0.2521929825,0.2404287902,0.2521929825,157,653,157,653,496,6,6,12,2,1,1,920,3648,920,3648,2728,1
679,687,9,9,0.5,0.9,0,9,0.9047619048,0.9841269841,0.9,0.9841269841,10,10,10,10,0,0,0,0,2,1,1,63,63,63,63,0,1
254,285,32,32,1,1,0,32,1,1,1,1,33,33,33,33,0,0,0,0,2,1,1,269,269,269,269,0,1
332,341,10,10,0.9,0.9,0,10,0.9579831933,0.9579831933,0.9,0.9579831933,10,10,10,10,0,0,0,0,2,1,1,115,119,115,119,4,1
152,163,12,12,0.9166666667,0.9166666667,0,12,0.9734513274,0.9911504425,0.9166666667,0.9911504425,12,12,12,12,0,1,1,2,2,1,1,112,113,112,113,1,1
403,450,48,48,1,1,0,48,1,1,1,1,48,48,48,48,0,0,0,0,2,1,1,336,336,336,336,0,1
376,454,65,79,0.8292682927,0.8292682927,14,72,0.9044776119,0.9044776119,0.0609756098,0.6343283582,68,82,68,82,14,0,0,0,3,2,1,606,670,606,670,64,1
1145,1178,34,34,1,1,0,34,1,1,1,1,36,36,36,36,0,0,0,0,2,1,1,257,257,257,257,0,1
635,647,13,13,0.4285714286,1,0,13,0.969924812,1,1,1,7,7,7,7,0,1,1,2,4,2,2,133,133,133,133,0,1
493,507,11,15,0.4375,0.5,4,13,0.8034682081,0.8554913295,0.125,0.6589595376,12,16,12,16,4,0,0,0,2,1,1,159,173,159,173,14,1
570,590,21,21,1,1,0,21,1,1,1,1,23,23,23,23,0,0,0,0,2,1,1,166,166,166,166,0,1
901,908,8,8,0.75,1,0,8,0.9545454545,1,1,1,8,8,8,8,0,0,0,0,2,1,1,66,66,66,66,0,1
629,646,18,19,0.8571428571,0.9047619048,1,18.5,0.8724832215,0.8926174497,0.7142857143,0.8187919463,21,20,20,21,1,0,0,0,2,1,1,149,137,137,149,12,1
481,529,49,58,0.8305084746,0.8305084746,9,53.5,0.7905982906,0.7905982906,0.3559322034,0.608974359,59,50,50,59,9,0,0,0,2,1,1,468,375,375,468,93,1
74,114,41,41,0.7804878049,0.7804878049,0,41,0.7936962751,0.8366762178,0.2195121951,0.5444126074,41,41,41,41,0,1,1,2,2,1,1,349,297,297,349,52,1
70,80,11,11,1,1,0,11,1,1,1,1,11,11,11,11,0,0,0,0,2,1,1,72,72,72,72,0,1
667,685,18,19,0.8571428571,0.9047619048,1,18.5,0.8724832215,0.8926174497,0.7142857143,0.8187919463,20,21,20,21,1,0,0,0,2,1,1,137,149,137,149,12,1
326,378,53,53,0.6222222222,1,0,53,0.9382716049,1,1,1,45,45,45,45,0,2,2,4,4,2,2,405,405,405,405,0,1
133,146,12,14,0.4285714286,0.7857142857,2,13,0.7034482759,0.7862068966,0.2857142857,0.6551724138,12,14,12,14,2,0,0,0,2,1,1,114,145,114,145,31,1
431,504,74,74,0.7076923077,1,0,74,0.9404388715,1,1,1,65,65,65,65,0,1,1,2,2,1,1,319,319,319,319,0,1
134,140,7,7,0.625,0.875,0,7,0.8481012658,0.8987341772,0.25,0.6455696203,8,8,8,8,0,0,0,0,2,1,1,79,71,71,79,8,1
548,570,23,23,1,1,0,23,1,1,1,1,25,25,25,25,0,0,0,0,2,1,1,187,187,187,187,0,1
181,187,7,7,0.625,1,0,7,0.9473684211,1,1,1,8,8,8,8,0,1,1,2,2,1,1,76,76,76,76,0,1
66,73,8,8,0.875,1,0,8,0.976744186,1,1,1,8,8,8,8,0,0,0,0,2,1,1,43,43,43,43,0,1
265,271,7,7,1,1,0,7,1,1,1,1,7,7,7,7,0,0,0,0,2,1,1,32,32,32,32,0,1
458,489,32,32,1,1,0,32,1,1,1,1,32,32,32,32,0,0,0,0,2,1,1,224,224,224,224,0,1
102,106,5,5,0.4,1,0,5,0.9473684211,1,1,1,5,5,5,5,0,2,2,4,2,1,1,57,57,57,57,0,1
39,64,19,26,0,0,7,22.5,0.4,0.6125,0,0.525,10,10,10,10,0,0,0,0,0,0,0,80,73,73,80,7,0
90,96,7,7,0.625,0.875,0,7,0.8481012658,0.8987341772,0.25,0.6455696203,8,8,8,8,0,0,0,0,2,1,1,79,71,71,79,8,1
732,741,10,10,0.6666666667,0.8333333333,0,10,0.9247311828,0.9569892473,0.8333333333,0.9569892473,12,12,12,12,0,0,0,0,2,1,1,90,93,90,93,3,1
96,100,5,5,0.6666666667,1,0,5,0.9672131148,1,1,1,6,6,6,6,0,2,2,4,2,1,1,61,61,61,61,0,1
286,295,10,10,0.9230769231,1,0,10,0.9918032787,1,1,1,13,13,13,13,0,0,0,0,2,1,1,122,122,122,122,0,1
73,81,9,10,0.7,0.8,1,9.5,0.8,0.8454545455,0.4,0.7272727273,10,9,9,10,1,1,1,2,2,1,1,110,94,94,110,16,1
99,111,13,13,1,1,0,13,1,1,1,1,13,13,13,13,0,0,0,0,2,1,1,117,117,117,117,0,1
175,181,7,7,1,1,0,7,1,1,1,1,7,7,7,7,0,0,0,0,2,1,1,32,32,32,32,0,1
461,474,13,14,0.7142857143,0.7857142857,1,13.5,0.8796992481,0.9172932331,0.5714285714,0.7969924812,13,14,13,14,1,0,0,0,2,1,1,133,128,128,133,5,1
440,452,13,13,1,1,0,13,1,1,1,1,13,13,13,13,0,0,0,0,2,1,1,133,133,133,133,0,1
88,96,9,9,0.7,1,0,9,0.9659090909,1,1,1,10,10,10,10,0,1,1,2,2,1,1,88,88,88,88,0,1
34,36,3,3,0,0.6666666667,0,3,0.75,0.9230769231,0.6666666667,0.9038461538,3,3,3,3,0,0,0,0,2,1,1,52,48,48,52,4,0
53,67,10,15,0.2,0.2,5,12.5,0.3168316832,0.504950495,0.2,0.4257425743,10,15,10,15,5,0,0,0,2,1,1,67,101,67,101,34,0
63,68,6,6,1,1,0,6,1,1,1,1,6,6,6,6,0,2,2,4,2,1,1,58,58,58,58,0,1
70,79,10,10,1,1,0,10,1,1,1,1,10,10,10,10,0,0,0,0,2,1,1,77,77,77,77,0,1
267,275,9,9,0.8571428571,1,0,9,0.987804878,1,1,1,7,7,7,7,0,1,1,2,4,2,2,82,82,82,82,0,1
385,390,6,6,1,1,0,6,1,1,1,1,7,7,7,7,0,0,0,0,2,1,1,64,64,64,64,0,1
500,521,22,22,0.8636363636,0.8636363636,0,22,0.88125,0.9125,0.6818181818,0.81875,22,22,22,22,0,0,0,0,2,1,1,160,146,146,160,14,1
381,391,11,11,0.3636363636,0.5454545455,0,11,0.5471698113,0.7169811321,0.4545454545,0.5660377358,11,11,11,11,0,0,0,0,2,1,1,48,53,48,53,5,0
55,59,5,5,0,1,0,5,0.9180327869,1,1,1,5,5,5,5,0,0,0,0,2,1,1,61,61,61,61,0,1
1207,1216,10,10,1,1,0,10,1,1,1,1,10,10,10,10,0,0,0,0,2,1,1,61,61,61,61,0,1
673,680,8,8,1,1,0,8,1,1,1,1,9,9,9,9,0,1,1,2,2,1,1,52,52,52,52,0,1
275,283,9,9,1,1,0,9,1,1,1,1,10,10,10,10,0,2,2,4,2,1,1,97,97,97,97,0,1
134,150,17,17,0.5263157895,0.8947368421,0,17,0.8901734104,0.9421965318,0.7894736842,0.9306358382,19,19,19,19,0,1,1,2,2,1,1,173,165,165,173,8,0
258,267,10,10,1,1,0,10,1,1,1,1,10,10,10,10,0,2,2,4,2,1,1,104,104,104,104,0,1
1154,1166,13,13,1,1,0,13,1,1,1,1,13,13,13,13,0,0,0,0,2,1,1,107,107,107,107,0,1
250,290,41,42,0.9761904762,0.9761904762,1,41.5,0.9678571429,0.9678571429,0.619047619,0.8821428571,42,41,41,42,1,0,0,0,2,1,1,280,271,271,280,9,1
332,411,80,80,1,1,0,80,1,1,1,1,80,80,80,80,0,0,0,0,2,1,1,560,560,560,560,0,1
115,125,11,11,1,1,0,11,1,1,1,1,12,12,12,12,0,0,0,0,2,1,1,83,83,83,83,0,1
533,541,9,9,1,1,0,9,1,1,1,1,10,10,10,10,0,0,0,0,2,1,1,109,109,109,109,0,1
60,85,20,26,0.1111111111,0.1851851852,6,23,0.390625,0.6614583333,0.1111111111,0.4479166667,20,27,20,27,7,0,0,0,2,1,1,192,192,192,192,0,0
529,539,10,11,0.5454545455,0.7272727273,1,10.5,0.8095238095,0.8888888889,0.3636363636,0.6825396825,10,11,10,11,1,0,0,0,2,1,1,58,63,58,63,5,1
1143,1153,11,11,0.6363636364,1,0,11,0.8260869565,1,1,1,11,11,11,11,0,0,0,0,2,1,1,46,46,46,46,0,1
743,748,6,6,0.8333333333,1,0,6,0.9861111111,1,1,1,6,6,6,6,0,1,1,2,2,1,1,72,72,72,72,0,1
163,170,8,8,0.875,1,0,8,0.9672131148,1,0.5,0.868852459,8,8,8,8,0,0,0,0,2,1,1,61,61,61,61,0,1
629,646,18,18,1,1,0,18,1,1,1,1,20,20,20,20,0,0,0,0,2,1,1,137,137,137,137,0,1
84,91,8,8,1,1,0,8,1,1,1,1,8,8,8,8,0,0,0,0,2,1,1,67,67,67,67,0,1
762,773,11,12,0.5833333333,0.8333333333,1,11.5,0.8240740741,0.9351851852,0.3333333333,0.75,11,12,11,12,1,0,0,0,2,1,1,105,108,105,108,3,1
741,757,17,17,1,1,0,17,1,1,1,1,17,17,17,17,0,0,0,0,2,1,1,103,103,103,103,0,1
1083,1093,11,11,0.4545454545,0.8181818182,0,11,0.6530612245,0.9183673469,0.8181818182,0.9183673469,11,11,11,11,0,0,0,0,2,1,1,49,46,46,49,3,1
257,270,14,14,1,1,0,14,1,1,1,1,16,16,16,16,0,0,0,0,2,1,1,122,122,122,122,0,1
631,647,17,17,0.375,1,0,17,0.9005847953,1,1,1,16,16,16,16,0,0,0,0,4,2,2,171,171,171,171,0,1
722,742,21,21,1,1,0,21,1,1,1,1,21,21,21,21,0,0,0,0,2,1,1,194,194,194,194,0,1
166,170,5,5,0.6666666667,1,0,5,0.9672131148,1,1,1,6,6,6,6,0,2,2,4,2,1,1,61,61,61,61,0,1
653,660,8,8,0.8888888889,1,0,8,0.9807692308,1,1,1,9,9,9,9,0,1,1,2,2,1,1,52,52,52,52,0,1
394,404,11,11,1,1,0,11,1,1,1,1,12,12,12,12,0,0,0,0,2,1,1,159,159,159,159,0,1
440,452,13,13,1,1,0,13,1,1,1,1,13,13,13,13,0,0,0,0,2,1,1,133,133,133,133,0,1
461,509,49,49,1,1,0,49,1,1,1,1,49,49,49,49,0,3,3,6,2,1,1,314,314,314,314,0,1
1435,1451,14,17,0.55,0.7,3,15.5,0.8634146341,0.9073170732,0.15,0.687804878,17,20,17,20,3,0,0,0,2,1,1,197,205,197,205,8,1
260,270,11,11,1,1,0,11,1,1,1,1,11,11,11,11,0,0,0,0,2,1,1,95,95,95,95,0,1
420,499,80,80,1,1,0,80,1,1,1,1,80,80,80,80,0,0,0,0,2,1,1,560,560,560,560,0,1
141,147,7,7,0.4285714286,0.7142857143,0,7,0.6470588235,0.8235294118,0.4285714286,0.7058823529,7,7,7,7,0,0,0,0,2,1,1,34,31,31,34,3,0
232,241,10,10,0.1,0.1,0,10,0.2358490566,0.3773584906,0.1,0.2830188679,10,10,10,10,0,2,2,4,2,1,1,106,61,61,106,45,0
76,116,18,41,0,1,23,29.5,0.5,1,0.4444444444,0.7777777778,9,9,9,9,0,0,0,0,0,0,0,36,36,36,36,0,0
367,379,13,13,1,1,0,13,1,1,1,1,13,13,13,13,0,0,0,0,2,1,1,124,124,124,124,0,1
436,449,14,14,0.2857142857,0.7142857143,0,14,0.6274509804,0.8431372549,0.2857142857,0.6568627451,14,14,14,14,0,0,0,0,2,1,1,96,102,96,102,6,1
1589,1604,16,16,1,1,0,16,1,1,1,1,16,16,16,16,0,0,0,0,2,1,1,204,204,204,204,0,1
906,911,5,6,0,0.6666666667,1,5.5,0.884057971,0.9420289855,0.6666666667,0.9420289855,5,6,5,6,1,0,1,1,3,1,2,69,67,67,69,2,0
184,198,15,15,0.8,0.8666666667,0,15,0.8253012048,0.8493975904,0.3333333333,0.6445783133,15,15,15,15,0,0,0,0,2,1,1,145,166,145,166,21,1
37,65,29,29,0.9285714286,0.9285714286,0,29,0.9803921569,0.9843137255,0.9285714286,0.9843137255,28,28,28,28,0,1,2,3,4,2,2,253,255,253,255,2,1
73,85,13,13,1,1,0,13,1,1,1,1,14,14,14,14,0,0,0,0,2,1,1,160,160,160,160,0,1
7,12,6,6,0.3333333333,0.6666666667,0,6,0.8518518519,0.962962963,0,0.5925925926,6,6,6,6,0,0,0,0,0,0,0,54,54,54,54,0,0
305,338,34,34,0.9117647059,0.9411764706,0,34,0.976635514,0.9813084112,0.5294117647,0.8738317757,34,34,34,34,0,1,0,1,2,1,1,214,210,210,214,4,1
469,492,24,24,1,1,0,24,1,1,1,1,24,24,24,24,0,0,0,0,2,1,1,168,168,168,168,0,1
31,36,6,7,0.1428571429,0.7142857143,1,6.5,0.5106382979,0.8510638298,0.1428571429,0.5744680851,7,6,6,7,1,0,0,0,2,1,1,47,41,41,47,6,0
458,488,31,31,1,1,0,31,1,1,1,1,31,31,31,31,0,0,0,0,2,1,1,217,217,217,217,0,1
55,69,15,15,1,1,0,15,1,1,1,1,17,17,17,17,0,0,0,0,4,2,2,104,104,104,104,0,1
268,316,14,49,0.0612244898,0.1020408163,35,31.5,0.1035940803,0.1691331924,0.0612244898,0.1205073996,14,49,14,49,35,0,0,0,2,1,1,91,473,91,473,382,0
629,646,18,21,0.7391304348,0.7826086957,3,19.5,0.7951807229,0.813253012,0.347826087,0.656626506,23,20,20,23,3,0,0,0,2,1,1,166,137,137,166,29,1
459,472,14,14,1,1,0,14,1,1,1,1,14,14,14,14,0,0,0,0,2,1,1,128,128,128,128,0,1
560,571,11,12,0.5833333333,0.9166666667,1,11.5,0.8859649123,0.9210526316,0.3333333333,0.7719298246,11,12,11,12,1,0,0,0,2,1,1,105,114,105,114,9,1
629,671,43,47,0.170212766,0.2553191489,4,45,0.3227848101,0.5253164557,0.170212766,0.3670886076,47,42,42,47,5,0,0,0,2,1,1,316,242,242,316,74,0
481,490,10,10,0.8,0.8,0,10,0.82,0.86,0.4,0.66,10,10,10,10,0,0,0,0,2,1,1,50,44,44,50,6,1
392,471,80,80,1,1,0,80,1,1,1,1,80,80,80,80,0,0,0,0,2,1,1,560,560,560,560,0,1
52,86,35,35,1,1,0,35,1,1,1,1,18,18,18,18,0,1,1,2,0,0,0,173,173,173,173,0,0
243,258,16,18,0.3333333333,0.8333333333,2,17,0.748603352,0.9217877095,0.3888888889,0.7988826816,18,16,16,18,2,0,0,0,2,1,1,179,171,171,179,8,1
305,330,26,26,1,1,0,26,1,1,1,1,26,26,26,26,0,0,0,0,2,1,1,182,182,182,182,0,1
97,107,10,11,0.1818181818,0.1818181818,1,10.5,0.4492753623,0.6376811594,0.1818181818,0.5217391304,10,11,10,11,1,0,0,0,2,1,1,69,63,63,69,6,0
90,172,83,83,1,1,0,83,1,1,1,1,83,83,83,83,0,0,0,0,2,1,1,756,756,756,756,0,1
394,404,11,11,1,1,0,11,1,1,1,1,12,12,12,12,0,0,0,0,2,1,1,159,159,159,159,0,1
238,250,13,14,0.5,0.8571428571,1,13.5,0.8203592814,0.8922155689,0.5,0.8143712575,14,13,13,14,1,0,0,0,2,1,1,167,154,154,167,13,1
571,592,22,22,0,0,0,22,0.1904761905,0.2857142857,0,0.2380952381,22,22,22,22,0,0,0,0,2,1,1,462,154,154,462,308,0
159,173,15,15,1,1,0,15,1,1,1,1,15,15,15,15,0,0,0,0,2,1,1,190,190,190,190,0,1
260,270,11,11,1,1,0,11,1,1,1,1,11,11,11,11,0,0,0,0,2,1,1,95,95,95,95,0,1
118,126,9,9,1,1,0,9,1,1,1,1,12,12,12,12,0,0,0,0,2,1,1,101,101,101,101,0,1
182,244,63,63,0.9666666667,0.9833333333,0,63,0.9727047146,0.9801488834,0.2833333333,0.699751861,60,60,60,60,0,3,3,6,2,1,1,395,403,395,403,8,0
30,44,15,15,1,1,0,15,1,1,1,1,15,15,15,15,0,0,0,0,2,1,1,72,72,72,72,0,1
81,91,11,11,1,1,0,11,1,1,1,1,11,11,11,11,0,0,0,0,2,1,1,41,41,41,41,0,1
451,482,32,32,1,1,0,32,1,1,1,1,32,32,32,32,0,0,0,0,2,1,1,224,224,224,224,0,0
238,244,7,7,0.8571428571,1,0,7,0.9836065574,1,1,1,7,7,7,7,0,1,1,2,2,1,1,61,61,61,61,0,1
8,27,20,20,1,1,0,20,1,1,1,1,12,12,12,12,0,3,3,6,2,1,1,73,73,73,73,0,1
507,511,5,5,0.8571428571,0.8571428571,0,5,0.875,0.8875,0.8571428571,0.8875,7,7,7,7,0,2,2,4,2,1,1,72,80,72,80,8,1
282,292,11,11,0.8181818182,0.8181818182,0,11,0.8556149733,0.9572192513,0.0909090909,0.8877005348,11,11,11,11,0,1,0,1,2,1,1,183,187,183,187,4,0
97,179,83,83,0.8536585366,1,0,83,0.9847826087,1,1,1,82,82,82,82,0,0,0,0,4,2,2,920,920,920,920,0,0
373,382,10,18,0.15,0.15,8,14,0.2152777778,0.3402777778,0.15,0.2569444444,20,10,10,20,10,0,0,0,2,1,1,144,59,59,144,85,0
290,290,1,1,0,0,0,1,0.2101740295,0.2262382865,0,0.2155287818,1,1,1,1,0,0,0,0,2,1,1,747,169,169,747,578,0
112,126,15,15,0.9411764706,0.9411764706,0,15,0.9493670886,0.9493670886,0.9411764706,0.9493670886,17,17,17,17,0,0,0,0,2,1,1,153,158,153,158,5,0
648,665,18,18,1,1,0,18,1,1,1,1,20,20,20,20,0,0,0,0,2,1,1,137,137,137,137,0,1
549,571,23,23,1,1,0,23,1,1,1,1,23,23,23,23,0,0,0,0,2,1,1,210,210,210,210,0,1
426,440,12,15,0.2,0.2666666667,3,13.5,0.3925233645,0.6074766355,0.2,0.4953271028,12,15,12,15,3,0,0,0,2,1,1,104,107,104,107,3,0
137,162,26,26,1,1,0,26,1,1,1,1,26,26,26,26,0,2,2,4,2,1,1,158,158,158,158,0,1
306,364,59,59,0.935483871,0.9677419355,0,59,0.954887218,0.962406015,0.5967741935,0.8552631579,62,62,62,62,0,0,0,0,2,1,1,532,520,520,532,12,1
97,106,10,12,0.0833333333,0.75,2,11,0.4468085106,0.8085106383,0.5,0.7446808511,12,10,10,12,2,0,0,0,2,1,1,47,39,39,47,8,0
1255,1292,38,38,1,1,0,38,1,1,1,1,39,39,39,39,0,0,0,0,2,1,1,307,307,307,307,0,1
184,198,15,15,1,1,0,15,1,1,1,1,15,15,15,15,0,0,0,0,2,1,1,198,198,198,198,0,1
546,557,11,12,0.5833333333,0.9166666667,1,11.5,0.8859649123,0.9210526316,0.3333333333,0.7719298246,11,12,11,12,1,0,0,0,2,1,1,105,114,105,114,9,1
474,495,22,22,1,1,0,22,1,1,1,1,22,22,22,22,0,0,0,0,2,1,1,154,154,154,154,0,0
135,182,48,48,1,1,0,48,1,1,1,1,48,48,48,48,0,0,0,0,2,1,1,318,318,318,318,0,1
560,571,12,12,0.75,0.9166666667,0,12,0.8684210526,0.9298245614,0.4166666667,0.7807017544,12,12,12,12,0,0,0,0,2,1,1,108,114,108,114,6,1
667,685,19,21,0.7391304348,0.7826086957,2,20,0.8192771084,0.8614457831,0.347826087,0.6987951807,23,21,21,23,2,0,0,0,2,1,1,166,149,149,166,17,1
54,79,18,26,0.1111111111,0.1481481481,8,22,0.2851405622,0.4698795181,0.1111111111,0.3172690763,18,27,18,27,9,0,0,0,2,1,1,152,249,152,249,97,0
1254,1293,40,40,1,1,0,40,1,1,1,1,19,19,19,19,0,4,4,8,4,2,2,79,79,79,79,0,1
406,441,36,36,1,1,0,36,1,1,1,1,38,38,38,38,0,0,0,0,2,1,1,349,349,349,349,0,1
459,501,43,43,1,1,0,43,1,1,1,1,46,46,46,46,0,0,0,0,2,1,1,314,314,314,314,0,1
10,1556,1,1547,0.0357142857,0.0357142857,1546,774,0.9316466933,0.9316466933,0.0357142857,0.9316466933,1,28,1,28,27,0,1,1,0,0,0,2099,2253,2099,2253,154,0
367,414,48,48,1,1,0,48,1,1,1,1,48,48,48,48,0,0,0,0,2,1,1,434,434,434,434,0,1
150,161,12,12,0.9230769231,1,0,12,0.9902912621,1,1,1,13,13,13,13,0,1,1,2,2,1,1,103,103,103,103,0,1
546,554,9,9,1,1,0,9,1,1,1,1,10,10,10,10,0,1,1,2,2,1,1,52,52,52,52,0,1
6,11,6,6,1,1,0,6,1,1,1,1,7,7,7,7,0,0,0,0,2,1,1,83,83,83,83,0,1
297,306,10,10,1,1,0,10,1,1,1,1,10,10,10,10,0,0,0,0,2,1,1,77,77,77,77,0,1
242,245,4,4,1,1,0,4,1,1,1,1,4,4,4,4,0,1,1,2,2,1,1,66,66,66,66,0,1
795,804,10,10,1,1,0,10,1,1,1,1,10,10,10,10,0,1,1,2,2,1,1,92,92,92,92,0,1
216,229,14,14,1,1,0,14,1,1,1,1,14,14,14,14,0,0,0,0,2,1,1,107,107,107,107,0,1
78,83,6,16,0.0909090909,0.1818181818,10,11,0.313253012,0.5301204819,0.0909090909,0.3975903614,11,7,7,11,4,3,0,3,3,2,1,83,74,74,83,9,0
358,365,8,8,1,1,0,8,1,1,1,1,8,8,8,8,0,0,0,0,2,1,1,51,51,51,51,0,1
90,101,12,12,1,1,0,12,1,1,1,1,12,12,12,12,0,0,0,0,2,1,1,100,100,100,100,0,1
188,212,25,25,0.75,1,0,25,0.9709543568,1,1,1,28,28,28,28,0,1,1,2,2,1,1,241,241,241,241,0,1
667,685,19,21,0.7391304348,0.7826086957,2,20,0.8192771084,0.8614457831,0.347826087,0.6987951807,23,21,21,23,2,0,0,0,2,1,1,166,149,149,166,17,1
546,568,23,23,0.88,1,0,23,0.9786096257,1,1,1,25,25,25,25,0,0,0,0,2,1,1,187,187,187,187,0,1
224,244,16,21,0.1904761905,0.4285714286,5,18.5,0.6518518519,0.7185185185,0.2380952381,0.6444444444,17,21,17,21,4,0,0,0,2,1,1,130,135,130,135,5,1
673,685,13,13,0.8461538462,1,0,13,0.9805825243,1,1,1,13,13,13,13,0,2,2,4,2,1,1,103,103,103,103,0,1
144,158,15,15,0.8235294118,0.8823529412,0,15,0.9603174603,0.9841269841,0.8823529412,0.9841269841,17,17,17,17,0,0,0,0,2,1,1,126,126,126,126,0,1
14,25,12,12,0.9285714286,0.9285714286,0,12,0.992481203,0.992481203,0.9285714286,0.992481203,14,14,14,14,0,0,0,0,2,1,1,133,132,132,133,1,1
650,667,18,23,0.68,0.72,5,20.5,0.7165775401,0.7326203209,0.32,0.5989304813,25,20,20,25,5,0,0,0,2,1,1,187,137,137,187,50,1
570,590,21,23,0.84,0.88,2,22,0.8395721925,0.871657754,0.68,0.807486631,25,23,23,25,2,0,0,0,2,1,1,187,166,166,187,21,1
631,650,20,20,0.8571428571,1,0,20,0.9806451613,1,1,1,21,21,21,21,0,1,1,2,4,2,2,155,155,155,155,0,1
1051,1062,12,12,1,1,0,12,1,1,1,1,12,12,12,12,0,1,1,2,2,1,1,106,106,106,106,0,1
803,820,11,18,0.3333333333,0.5,7,14.5,0.6810344828,0.7327586207,0.1666666667,0.5603448276,12,18,12,18,6,0,0,0,2,1,1,86,116,86,116,30,1
508,552,45,45,1,1,0,45,1,1,1,1,45,45,45,45,0,2,2,4,2,1,1,328,328,328,328,0,1
631,648,18,21,0.7391304348,0.7826086957,3,19.5,0.7951807229,0.813253012,0.347826087,0.656626506,23,20,20,23,3,0,0,0,2,1,1,166,137,137,166,29,1
353,364,12,12,0.4,1,0,12,0.8512396694,1,1,1,15,15,15,15,0,1,1,2,2,1,1,121,121,121,121,0,1
640,653,14,14,0.4285714286,0.8571428571,0,14,0.8639455782,0.9727891156,0.5714285714,0.8911564626,14,14,14,14,0,0,0,0,2,1,1,145,147,145,147,2,1
1,33,33,33,1,1,0,33,1,1,1,1,28,28,28,28,0,0,0,0,0,0,0,334,334,334,334,0,1
299,309,11,11,0.8333333333,0.8333333333,0,11,0.9411764706,0.9411764706,0.8333333333,0.9411764706,12,12,12,12,0,0,0,0,2,1,1,68,65,65,68,3,1
353,394,42,42,0.976744186,0.976744186,0,42,0.9824561404,0.9824561404,0.6046511628,0.898245614,42,43,42,43,1,0,0,0,2,1,1,280,285,280,285,5,1
126,138,13,13,1,1,0,13,1,1,1,1,13,13,13,13,0,0,0,0,2,1,1,111,111,111,111,0,1
648,665,18,18,0.9,1,0,18,0.9854014599,1,1,1,20,20,20,20,0,0,0,0,2,1,1,137,137,137,137,0,1
715,732,17,18,0.7777777778,0.8888888889,1,17.5,0.8142857143,0.85,0.3333333333,0.6571428571,17,18,17,18,1,0,0,0,2,1,1,119,140,119,140,21,1
50,57,7,8,0,0.25,1,7.5,0.3442622951,0.5409836066,0,0.4262295082,7,8,7,8,1,2,1,3,2,1,1,61,58,58,61,3,0
32,51,18,20,0.2,0.75,2,19,0.748447205,0.8354037267,0.35,0.8074534161,18,20,18,20,2,0,0,0,2,1,1,270,322,270,322,52,1
546,568,23,23,1,1,0,23,1,1,1,1,25,25,25,25,0,0,0,0,2,1,1,187,187,187,187,0,1
53,166,114,114,0.9579831933,0.9579831933,0,114,0.9953746531,0.9953746531,0.9579831933,0.9953746531,119,119,119,119,0,0,0,0,2,1,1,1076,1081,1076,1081,5,1
620,625,6,6,1,1,0,6,1,1,1,1,6,6,6,6,0,0,0,0,2,1,1,28,28,28,28,0,1
585,592,8,8,0.8888888889,1,0,8,0.9807692308,1,1,1,9,9,9,9,0,1,1,2,2,1,1,52,52,52,52,0,1
198,217,20,20,0.8571428571,0.9047619048,0,20,0.9558823529,0.9632352941,0.4285714286,0.8088235294,21,21,21,21,0,2,2,4,2,1,1,136,132,132,136,4,1
132,141,10,10,0.5,1,0,10,0.9230769231,1,1,1,10,10,10,10,0,0,0,0,2,1,1,65,65,65,65,0,0
463,472,10,10,0.8,0.8,0,10,0.82,0.86,0.4,0.66,10,10,10,10,0,0,0,0,2,1,1,44,50,44,50,6,1
432,448,17,17,1,1,0,17,1,1,1,1,17,17,17,17,0,0,0,0,2,1,1,119,119,119,119,0,1
482,505,24,24,1,1,0,24,1,1,1,1,24,24,24,24,0,0,0,0,2,1,1,168,168,168,168,0,1
478,493,16,17,0.7058823529,0.8823529412,1,16.5,0.8068181818,0.875,0.5882352941,0.8068181818,17,16,16,17,1,0,0,0,2,1,1,88,84,84,88,4,1
1077,1105,29,29,0.8275862069,0.8965517241,0,29,0.871559633,0.8990825688,0.275862069,0.7247706422,29,29,29,29,0,0,0,0,2,1,1,218,198,198,218,20,1
213,233,21,23,0.8695652174,0.8695652174,2,22,0.7659574468,0.7659574468,0.2608695652,0.5265957447,23,21,21,23,2,0,0,0,2,1,1,188,153,153,188,35,1
232,245,14,14,1,1,0,14,1,1,1,1,14,14,14,14,0,0,0,0,2,1,1,107,107,107,107,0,1
1,204,204,204,1,1,0,204,1,1,1,1,185,185,185,185,0,0,0,0,0,0,0,1550,1550,1550,1550,0,1
132,140,9,9,1,1,0,9,1,1,1,1,11,11,11,11,0,0,0,0,2,1,1,129,129,129,129,0,1
108,114,7,7,0.625,1,0,7,0.9240506329,1,1,1,8,8,8,8,0,0,0,0,2,1,1,79,79,79,79,0,1
91,105,13,15,0.5333333333,0.8,2,14,0.7961165049,0.8737864078,0.7333333333,0.854368932,13,15,13,15,2,0,0,0,2,1,1,94,103,94,103,9,1
260,270,11,11,1,1,0,11,1,1,1,1,11,11,11,11,0,0,0,0,2,1,1,95,95,95,95,0,1
179,190,12,12,1,1,0,12,1,1,1,1,12,12,12,12,0,1,1,2,2,1,1,74,74,74,74,0,1
804,816,13,13,0.6153846154,0.9230769231,0,13,0.9426229508,0.9918032787,0.6923076923,0.9508196721,13,13,13,13,0,0,0,0,2,1,1,121,122,121,122,1,1
565,575,9,11,0.6153846154,0.7692307692,2,10,0.7171717172,0.7474747475,0.3846153846,0.5757575758,11,13,11,13,2,0,0,0,2,1,1,75,99,75,99,24,1
316,324,9,9,1,1,0,9,1,1,1,1,9,9,9,9,0,0,0,0,2,1,1,112,112,112,112,0,1
26,57,32,42,0.0238095238,0.1666666667,10,37,0.3144876325,0.5335689046,0.0238095238,0.3392226148,42,33,33,42,9,0,0,0,2,1,1,211,283,211,283,72,0
925,937,13,13,0.6153846154,1,0,13,0.958677686,1,1,1,13,13,13,13,0,0,0,0,2,1,1,121,121,121,121,0,1
90,172,83,83,1,1,0,83,1,1,1,1,83,83,83,83,0,0,0,0,2,1,1,756,756,756,756,0,1
217,230,11,14,0.2857142857,0.7142857143,3,12.5,0.5394736842,0.7368421053,0.4285714286,0.6052631579,11,14,11,14,3,0,0,0,2,1,1,56,76,56,76,20,0
310,404,95,95,1,1,0,95,1,1,1,1,95,95,95,95,0,0,0,0,2,1,1,742,742,742,742,0,1
31,45,15,33,0.1212121212,0.1212121212,18,24,0.1612903226,0.247311828,0.1212121212,0.1863799283,33,15,15,33,18,0,0,0,2,1,1,279,85,85,279,194,0
45,49,5,5,0,0.8,0,5,0.6904761905,0.7857142857,0.8,0.7857142857,5,5,5,5,0,0,0,0,2,1,1,84,67,67,84,17,0
315,331,12,17,0.1818181818,0.4545454545,5,14.5,0.5,0.7375,0.1818181818,0.5625,11,10,10,11,1,0,0,0,4,2,2,80,70,70,80,10,0
313,329,17,17,1,1,0,17,1,1,1,1,17,17,17,17,0,0,0,0,2,1,1,119,119,119,119,0,0
277,297,16,21,0.1904761905,0.2380952381,5,18.5,0.2967741935,0.4709677419,0.1904761905,0.3483870968,17,21,17,21,4,0,0,0,2,1,1,107,155,107,155,48,0
10,10,1,8,0.1428571429,0.1428571429,7,4.5,0.9859088774,0.9859088774,0.1428571429,0.9859088774,7,1,1,7,6,1,0,1,1,1,0,2129,2099,2099,2129,30,0
491,518,28,32,0.1875,0.25,4,30,0.4019607843,0.6176470588,0.1875,0.431372549,32,28,28,32,4,0,0,0,2,1,1,184,204,184,204,20,0
556,570,15,15,0.9333333333,0.9333333333,0,15,0.8426966292,0.8764044944,0.9333333333,0.8651685393,15,15,15,15,0,2,2,4,4,2,2,78,89,78,89,11,1
150,176,22,27,0.7777777778,0.7777777778,5,24.5,0.871559633,0.876146789,0.4074074074,0.8073394495,22,27,22,27,5,0,0,0,2,1,1,195,218,195,218,23,1
522,544,18,23,0.68,0.72,5,20.5,0.7165775401,0.7326203209,0.32,0.5989304813,20,25,20,25,5,0,0,0,2,1,1,137,187,137,187,50,1
170,182,12,13,0.5384615385,0.6153846154,1,12.5,0.8083333333,0.8583333333,0.4615384615,0.7916666667,12,13,12,13,1,0,0,0,2,1,1,120,114,114,120,6,0
695,714,20,20,1,1,0,20,1,1,1,1,21,21,21,21,0,0,0,0,2,1,1,114,114,114,114,0,1
314,336,23,23,0.9565217391,0.9565217391,0,23,0.9788135593,0.9788135593,0.9565217391,0.9788135593,23,23,23,23,0,0,0,0,2,1,1,231,236,231,236,5,1
159,173,15,15,1,1,0,15,1,1,1,1,15,15,15,15,0,0,0,0,2,1,1,190,190,190,190,0,1
395,416,20,22,0.4090909091,0.7272727273,2,21,0.6781609195,0.7931034483,0.4090909091,0.632183908,20,22,20,22,2,0,0,0,2,1,1,87,85,85,87,2,1
349,379,31,31,1,1,0,31,1,1,1,1,31,31,31,31,0,0,0,0,2,1,1,217,217,217,217,0,1
565,587,23,23,0.9565217391,0.9565217391,0,23,0.9904761905,0.9904761905,0.9565217391,0.9904761905,23,23,23,23,0,0,0,0,2,1,1,210,208,208,210,2,1
227,236,10,11,0.7692307692,0.7692307692,1,10.5,0.8181818182,0.8282828283,0.2307692308,0.6262626263,13,12,12,13,1,0,0,0,2,1,1,99,82,82,99,17,1
445,461,17,17,1,1,0,17,1,1,1,1,17,17,17,17,0,0,0,0,2,1,1,119,119,119,119,0,1
573,587,15,15,0.8666666667,1,0,15,0.9727891156,1,1,1,15,15,15,15,0,0,0,0,2,1,1,147,147,147,147,0,1
509,520,12,12,1,1,0,12,1,1,1,1,13,13,13,13,0,0,0,0,2,1,1,123,123,123,123,0,1
314,339,26,26,1,1,0,26,1,1,1,1,26,26,26,26,0,0,0,0,2,1,1,182,182,182,182,0,1
1244,1280,37,37,1,1,0,37,1,1,1,1,40,40,40,40,0,0,0,0,2,1,1,332,332,332,332,0,1
289,304,16,18,0.3333333333,0.7777777778,2,17,0.5891891892,0.772972973,0.2222222222,0.4972972973,18,16,16,18,2,0,0,0,2,1,1,185,143,143,185,42,1
216,229,14,14,1,1,0,14,1,1,1,1,14,14,14,14,0,0,0,0,2,1,1,107,107,107,107,0,1
824,857,34,34,1,1,0,34,1,1,1,1,34,34,34,34,0,0,0,0,2,1,1,210,210,210,210,0,1
335,349,15,15,1,1,0,15,1,1,1,1,15,15,15,15,0,0,0,0,2,1,1,117,117,117,117,0,1
375,396,22,22,1,1,0,22,1,1,1,1,22,22,22,22,0,0,0,0,2,1,1,154,154,154,154,0,1
334,353,19,20,0.35,0.65,1,19.5,0.8073394495,0.9266055046,0.1,0.628440367,19,20,19,20,1,0,0,0,2,1,1,207,218,207,218,11,0
30,44,15,15,1,1,0,15,1,1,1,1,15,15,15,15,0,0,0,0,2,1,1,72,72,72,72,0,1
268,276,9,9,0.7,1,0,9,0.9655172414,1,1,1,10,10,10,10,0,1,1,2,2,1,1,87,87,87,87,0,1
497,517,21,21,0.6,1,0,21,0.9397590361,1,1,1,20,20,20,20,0,1,1,2,2,1,1,166,166,166,166,0,1
450,492,43,43,1,1,0,43,1,1,1,1,46,46,46,46,0,0,0,0,2,1,1,314,314,314,314,0,1
19,34,16,16,1,1,0,16,1,1,1,1,16,16,16,16,0,0,0,0,2,1,1,119,119,119,119,0,1
194,206,13,13,1,1,0,13,1,1,1,1,14,14,14,14,0,0,0,0,2,1,1,83,83,83,83,0,1
414,433,20,20,1,1,0,20,1,1,1,1,21,21,21,21,0,0,0,0,2,1,1,189,189,189,189,0,1
836,840,5,5,0,0,0,5,0.4189189189,0.527027027,0,0.3918918919,6,6,6,6,0,1,1,2,2,1,1,74,62,62,74,12,0
150,189,40,40,1,1,0,40,1,1,1,1,40,40,40,40,0,1,1,2,4,2,2,303,303,303,303,0,0
351,371,21,21,1,1,0,21,1,1,1,1,21,21,21,21,0,1,1,2,2,1,1,286,286,286,286,0,1
560,577,18,18,0.3333333333,0.9444444444,0,18,0.7621621622,0.9675675676,0.3888888889,0.8162162162,18,18,18,18,0,0,0,0,2,1,1,185,179,179,185,6,1
762,773,12,12,0.6666666667,0.9166666667,0,12,0.8596491228,0.9298245614,0.4166666667,0.7807017544,12,12,12,12,0,0,0,0,2,1,1,114,108,108,114,6,1
452,468,16,17,0.7058823529,0.7058823529,1,16.5,0.7465753425,0.7465753425,0.2352941176,0.5410958904,16,17,16,17,1,0,0,0,2,1,1,146,137,137,146,9,1
819,829,11,11,0.8181818182,1,0,11,0.9347826087,1,1,1,11,11,11,11,0,0,0,0,2,1,1,46,46,46,46,0,1
675,683,9,9,0.7777777778,1,0,9,0.9848484848,1,1,1,9,9,9,9,0,2,2,4,2,1,1,132,132,132,132,0,1
132,148,17,17,0.5263157895,0.8421052632,0,17,0.8352272727,0.8977272727,0.4210526316,0.6875,19,19,19,19,0,1,0,1,2,1,1,166,176,166,176,10,0
98,122,25,25,0.75,1,0,25,0.9711934156,1,1,1,28,28,28,28,0,1,1,2,2,1,1,243,243,243,243,0,1
560,571,12,13,0.6153846154,0.9230769231,1,12.5,0.867768595,0.9421487603,0.3076923077,0.7603305785,13,12,12,13,1,0,0,0,2,1,1,121,114,114,121,7,1
964,980,17,18,0.7222222222,0.8333333333,1,17.5,0.8098591549,0.838028169,0.5555555556,0.7535211268,18,17,17,18,1,0,0,0,2,1,1,142,136,136,142,6,1
790,801,11,12,0.5,0.8333333333,1,11.5,0.8347826087,0.9130434783,0.3333333333,0.747826087,11,12,11,12,1,0,0,0,2,1,1,105,115,105,115,10,1
240,260,21,21,0.7894736842,0.9473684211,0,21,0.9439655172,0.9784482759,0.9473684211,0.9612068966,19,19,19,19,0,1,1,2,4,2,2,232,228,228,232,4,1
